㐷	傌
㐹	㑶
㐽	偑
㑇	㑳
㑈	倲
㑔	㑯
㑩	儸
㓆	𠗣
㓥	劏
㓰	劃
㔉	劚
㖊	噚
㖞	喎
㗷	㘔
㘎	㘚
㚯	㜄
㛀	媰
㛟	𡞵
㛠	𡢃
㛣	㜏
㛤	孋
㛿	𡠹
㟆	㠏
㟜	𡾱
㟥	嵾
㡎	幓
㤘	㥮
㤽	懤
㥪	慺
㧏	掆
㧐	㩳
㧑	撝
㧟	擓
㧰	擽
㨫	㩜
㭎	棡
㭏	椲
㭣	𣙎
㭤	樢
㭴	樫
㱩	殰
㱮	殨
㲿	瀇
㳔	濧
㳕	灡
㳠	澾
㳡	濄
㳢	𣾷
㳽	瀰
㴋	潚
㶉	鸂
㶶	燶
㶽	煱
㺍	獱
㻅	璯
㻏	𤫩
㻘	𤪺
䀥	䁻
䁖	瞜
䂵	碽
䃅	磾
䅉	稏
䅟	穇
䅪	𥢢
䇲	筴
䉤	籔
䌶	䊷
䌷	紬
䌸	縳
䌹	絅
䌺	䋙
䌻	䋚
䌼	綐
䌽	綵
䌾	䋻
䌿	䋹
䍀	繿
䍁	繸
䍠	䍦
䎬	䎱
䏝	膞
䑽	𦪙
䓓	薵
䓕	薳
䓖	藭
䓨	罃
䗖	螮
䘛	𧝞
䘞	𧜗
䙊	𧜵
䙌	䙡
䙓	襬
䜣	訢
䜤	鿁
䜥	𧩙
䜧	䜀
䜩	讌
䝙	貙
䞌	𧵳
䞍	䝼
䞎	𧶧
䞐	賰
䟢	躎
䢀	𨊰
䢁	𨊸
䢂	𨋢
䥺	釾
䥽	鏺
䥾	䥱
䥿	𨯅
䦀	𨦫
䦁	𨧜
䦂	䥇
䦃	鐯
䦅	鐥
䦆	钁
䦶	䦛
䦷	䦟
䩄	靦
䭪	𩞯
䯃	𩣑
䯄	騧
䯅	䯀
䲝	䱽
䲞	𩶘
䲟	鮣
䲠	鰆
䲡	鰌
䲢	鰧
䲣	䱷
䴓	鳾
䴔	鵁
䴕	鴷
䴖	鶄
䴗	鶪
䴘	鷈
䴙	鷿
䶮	龑
万	萬
与	與
丑	醜
专	專
业	業
丛	叢
东	東
丝	絲
丢	丟
两	兩
严	嚴
丧	喪
个	個
丰	豐
临	臨
为	爲
丽	麗
举	舉
么	麼
义	義
乌	烏
乐	樂
乔	喬
习	習
乡	鄉
书	書
买	買
乱	亂
了	了
争	爭
于	於
亏	虧
云	雲
亘	亙
亚	亞
产	產
亩	畝
亲	親
亵	褻
亸	嚲
亿	億
仅	僅
仆	僕
仇	仇
从	從
仑	侖
仓	倉
仪	儀
们	們
价	價
仿	仿
众	衆
优	優
伙	夥
会	會
伛	傴
伞	傘
伟	偉
传	傳
伡	俥
伣	俔
伤	傷
伥	倀
伦	倫
伧	傖
伪	僞
伫	佇
体	體
余	餘
佛	佛
佣	傭
佥	僉
侠	俠
侣	侶
侥	僥
侦	偵
侧	側
侨	僑
侩	儈
侪	儕
侬	儂
侭	儘
俊	俊
俣	俁
俦	儔
俨	儼
俩	倆
俪	儷
俫	倈
俭	儉
修	修
借	借
债	債
倾	傾
偬	傯
偻	僂
偾	僨
偿	償
傤	儎
傥	儻
傧	儐
储	儲
傩	儺
僵	僵
儿	兒
克	克
兑	兌
兖	兗
党	黨
兰	蘭
关	關
兴	興
兹	茲
养	養
兽	獸
冁	囅
内	內
冈	岡
册	冊
写	寫
军	軍
农	農
冬	冬
冯	馮
冲	衝
决	決
况	況
冻	凍
净	淨
凄	悽
准	準
凉	涼
凌	凌
减	減
凑	湊
凛	凜
几	幾
凤	鳳
凫	鳧
凭	憑
凯	凱
凶	兇
出	出
击	擊
凿	鑿
刍	芻
划	劃
刘	劉
则	則
刚	剛
创	創
删	刪
别	別
刬	剗
刭	剄
刮	刮
制	制
刹	剎
刽	劊
刾	㓨
刿	劌
剀	剴
剂	劑
剐	剮
剑	劍
剥	剝
剧	劇
劝	勸
办	辦
务	務
劢	勱
动	動
励	勵
劲	勁
劳	勞
势	勢
勋	勳
勚	勩
匀	勻
匦	匭
匮	匱
区	區
医	醫
千	千
升	升
华	華
协	協
单	單
卖	賣
卜	卜
占	佔
卢	盧
卤	滷
卧	臥
卫	衛
却	卻
卷	卷
卺	巹
厂	廠
厅	廳
历	歷
厉	厲
压	壓
厌	厭
厍	厙
厐	龎
厕	廁
厘	釐
厢	廂
厣	厴
厦	廈
厨	廚
厩	廄
厮	廝
县	縣
叁	叄
参	參
叆	靉
叇	靆
双	雙
发	發
变	變
叙	敘
叠	疊
只	只
台	臺
叶	葉
号	號
叹	嘆
叽	嘰
吁	籲
吃	喫
合	合
吊	吊
同	同
后	後
向	向
吓	嚇
吕	呂
吗	嗎
吣	唚
吨	噸
听	聽
启	啓
吴	吳
呐	吶
呒	嘸
呓	囈
呕	嘔
呖	嚦
呗	唄
员	員
呙	咼
呛	嗆
呜	嗚
周	周
咏	詠
咙	嚨
咛	嚀
咝	噝
咤	吒
咨	諮
咸	鹹
咽	咽
哄	哄
响	響
哑	啞
哒	噠
哓	嘵
哔	嗶
哕	噦
哗	譁
哙	噲
哜	嚌
哝	噥
哟	喲
唇	脣
唛	嘜
唝	嗊
唠	嘮
唡	啢
唢	嗩
唤	喚
啧	嘖
啬	嗇
啭	囀
啮	齧
啯	嘓
啰	囉
啴	嘽
啸	嘯
喂	喂
喷	噴
喽	嘍
喾	嚳
嗫	囁
嗳	噯
嘘	噓
嘤	嚶
嘱	囑
噜	嚕
噪	噪
嚣	囂
回	回
团	團
园	園
困	困
囱	囪
围	圍
囵	圇
国	國
图	圖
圆	圓
圣	聖
圹	壙
场	場
坂	阪
坏	壞
坐	坐
块	塊
坚	堅
坛	壇
坜	壢
坝	壩
坞	塢
坟	墳
坠	墜
垄	壟
垅	壠
垆	壚
垒	壘
垦	墾
垩	堊
垫	墊
垭	埡
垯	墶
垱	壋
垲	塏
垴	堖
埘	塒
埙	壎
埚	堝
埯	垵
堑	塹
堕	墮
塆	壪
墙	牆
壮	壯
声	聲
壳	殼
壶	壺
壸	壼
处	處
备	備
复	復
够	夠
夫	夫
头	頭
夸	誇
夹	夾
夺	奪
奁	奩
奂	奐
奋	奮
奖	獎
奥	奧
奸	奸
妆	妝
妇	婦
妈	媽
妩	嫵
妪	嫗
妫	嬀
姗	姍
姜	姜
姹	奼
娄	婁
娅	婭
娆	嬈
娇	嬌
娈	孌
娘	娘
娱	娛
娲	媧
娴	嫺
婳	嫿
婴	嬰
婵	嬋
婶	嬸
媪	媼
媭	嬃
嫒	嬡
嫔	嬪
嫱	嬙
嬷	嬤
孙	孫
学	學
孪	孿
宁	寧
宝	寶
实	實
宠	寵
审	審
宪	憲
宫	宮
家	家
宽	寬
宾	賓
寝	寢
对	對
寻	尋
导	導
寿	壽
将	將
尔	爾
尘	塵
尝	嘗
尧	堯
尴	尷
尸	屍
尽	盡
局	局
层	層
屃	屓
屉	屜
届	屆
属	屬
屡	屢
屦	屨
屿	嶼
岁	歲
岂	豈
岖	嶇
岗	崗
岘	峴
岙	嶴
岚	嵐
岛	島
岩	巖
岭	嶺
岳	嶽
岽	崬
岿	巋
峃	嶨
峄	嶧
峡	峽
峣	嶢
峤	嶠
峥	崢
峦	巒
峰	峯
崂	嶗
崃	崍
崄	嶮
崭	嶄
嵘	嶸
嵚	嶔
嵝	嶁
巅	巔
巨	巨
巩	鞏
巯	巰
币	幣
布	布
帅	帥
师	師
帏	幃
帐	帳
帘	簾
帜	幟
带	帶
帧	幀
席	席
帮	幫
帱	幬
帻	幘
帼	幗
幂	冪
幞	襆
干	幹
并	並
幸	幸
广	廣
庄	莊
庆	慶
床	牀
庐	廬
庑	廡
库	庫
应	應
庙	廟
庞	龐
废	廢
庵	庵
庼	廎
廪	廩
开	開
异	異
弃	棄
弑	弒
张	張
弥	彌
弦	弦
弪	弳
弯	彎
弹	彈
强	強
归	歸
当	當
录	錄
彟	彠
彦	彥
彨	彲
彩	彩
彻	徹
征	徵
径	徑
徕	徠
御	御
忆	憶
忏	懺
志	志
忧	憂
念	念
忾	愾
怀	懷
态	態
怂	慫
怃	憮
怄	慪
怅	悵
怆	愴
怜	憐
总	總
怼	懟
怿	懌
恋	戀
恒	恆
恤	恤
恳	懇
恶	惡
恸	慟
恹	懨
恺	愷
恻	惻
恼	惱
恽	惲
悦	悅
悫	愨
悬	懸
悭	慳
悮	悞
悯	憫
惊	驚
惧	懼
惨	慘
惩	懲
惫	憊
惬	愜
惭	慚
惮	憚
惯	慣
愈	愈
愠	慍
愤	憤
愦	憒
愿	願
慑	懾
慭	憖
懑	懣
懒	懶
懔	懍
戆	戇
戋	戔
戏	戲
戗	戧
战	戰
戚	戚
戬	戩
戯	戱
户	戶
才	才
扎	扎
扑	撲
托	託
扣	扣
执	執
扩	擴
扪	捫
扫	掃
扬	揚
扰	擾
折	折
抚	撫
抛	拋
抟	摶
抠	摳
抡	掄
抢	搶
护	護
报	報
抬	擡
抵	抵
担	擔
拐	拐
拟	擬
拢	攏
拣	揀
拥	擁
拦	攔
拧	擰
拨	撥
择	擇
挂	掛
挚	摯
挛	攣
挜	掗
挝	撾
挞	撻
挟	挾
挠	撓
挡	擋
挢	撟
挣	掙
挤	擠
挥	揮
挦	撏
挨	挨
挽	挽
捝	挩
捞	撈
损	損
捡	撿
换	換
捣	搗
据	據
掳	擄
掴	摑
掷	擲
掸	撣
掺	摻
掼	摜
揽	攬
揾	搵
揿	撳
搀	攙
搁	擱
搂	摟
搄	揯
搅	攪
搜	搜
携	攜
摄	攝
摅	攄
摆	擺
摇	搖
摈	擯
摊	攤
撄	攖
撑	撐
撵	攆
撷	擷
撸	擼
撺	攛
擜	㩵
擞	擻
攒	攢
敌	敵
敚	敓
敛	斂
敩	斆
数	數
斋	齋
斓	斕
斗	鬥
斩	斬
断	斷
无	無
旧	舊
时	時
旷	曠
旸	暘
昆	昆
昙	曇
昵	暱
昼	晝
昽	曨
显	顯
晋	晉
晒	曬
晓	曉
晔	曄
晕	暈
晖	暉
暂	暫
暅	𣈶
暗	暗
暧	曖
曲	曲
术	術
朱	朱
朴	樸
机	機
杀	殺
杂	雜
权	權
杆	杆
杠	槓
条	條
来	來
杨	楊
杩	榪
杯	杯
杰	傑
松	鬆
板	板
极	極
构	構
枞	樅
枢	樞
枣	棗
枥	櫪
枧	梘
枨	棖
枪	槍
枫	楓
枭	梟
柜	櫃
柠	檸
柽	檉
栀	梔
栅	柵
标	標
栈	棧
栉	櫛
栊	櫳
栋	棟
栌	櫨
栎	櫟
栏	欄
树	樹
栖	棲
栗	慄
样	樣
核	核
栾	欒
桠	椏
桡	橈
桢	楨
档	檔
桤	榿
桥	橋
桦	樺
桧	檜
桨	槳
桩	樁
桪	樳
梁	梁
梦	夢
梼	檮
梾	棶
梿	槤
检	檢
棁	梲
棂	櫺
椁	槨
椝	槼
椟	櫝
椠	槧
椢	槶
椤	欏
椫	樿
椭	橢
椮	槮
楼	樓
榄	欖
榅	榲
榇	櫬
榈	櫚
榉	櫸
榝	樧
槚	檟
槛	檻
槟	檳
槠	櫧
横	橫
樯	檣
樱	櫻
橥	櫫
橱	櫥
橹	櫓
橼	櫞
檩	檁
欢	歡
欤	歟
欧	歐
欲	欲
歼	殲
殁	歿
殇	殤
残	殘
殒	殞
殓	殮
殚	殫
殡	殯
殴	毆
毁	毀
毂	轂
毕	畢
毙	斃
毡	氈
毵	毿
毶	毿
氇	氌
气	氣
氢	氫
氩	氬
氲	氳
汇	匯
汉	漢
汤	湯
汹	洶
沈	沈
沟	溝
没	沒
沣	灃
沤	漚
沥	瀝
沦	淪
沧	滄
沨	渢
沩	潙
沪	滬
泛	泛
泞	濘
注	注
泪	淚
泶	澩
泷	瀧
泸	瀘
泺	濼
泻	瀉
泼	潑
泽	澤
泾	涇
洁	潔
洒	灑
洼	窪
浃	浹
浅	淺
浆	漿
浇	澆
浈	湞
浉	溮
浊	濁
测	測
浍	澮
济	濟
浏	瀏
浐	滻
浑	渾
浒	滸
浓	濃
浔	潯
浕	濜
涂	塗
涚	涗
涛	濤
涝	澇
涞	淶
涟	漣
涠	潿
涡	渦
涢	溳
涣	渙
涤	滌
润	潤
涧	澗
涨	漲
涩	澀
淀	澱
渊	淵
渌	淥
渍	漬
渎	瀆
渐	漸
渑	澠
渔	漁
渖	瀋
渗	滲
温	溫
游	遊
湾	灣
湿	溼
溁	濚
溃	潰
溅	濺
溆	漵
溇	漊
滗	潷
滚	滾
滞	滯
滟	灩
滠	灄
满	滿
滢	瀅
滤	濾
滥	濫
滦	灤
滨	濱
滩	灘
滪	澦
漓	漓
潆	瀠
潇	瀟
潋	瀲
潍	濰
潜	潛
潴	瀦
澛	瀂
澜	瀾
濑	瀨
濒	瀕
灏	灝
灭	滅
灯	燈
灵	靈
灶	竈
灾	災
灿	燦
炀	煬
炉	爐
炖	燉
炜	煒
炝	熗
点	點
炼	煉
炽	熾
烁	爍
烂	爛
烃	烴
烛	燭
烟	煙
烦	煩
烧	燒
烨	燁
烩	燴
烫	燙
烬	燼
热	熱
焕	煥
焖	燜
焘	燾
煴	熅
熏	薰
爱	愛
爷	爺
牍	牘
牦	犛
牵	牽
牺	犧
犊	犢
状	狀
犷	獷
犸	獁
犹	猶
狈	狽
狝	獮
狞	獰
独	獨
狭	狹
狮	獅
狯	獪
狰	猙
狱	獄
狲	猻
猃	獫
猎	獵
猕	獼
猡	玀
猪	豬
猫	貓
猬	蝟
献	獻
獭	獺
玑	璣
玙	璵
玚	瑒
玛	瑪
玮	瑋
环	環
现	現
玱	瑲
玺	璽
珐	琺
珑	瓏
珰	璫
珲	琿
琎	璡
琏	璉
琐	瑣
琼	瓊
瑶	瑤
瑷	璦
瑸	璸
璎	瓔
瓒	瓚
瓮	甕
瓯	甌
电	電
画	畫
畅	暢
畴	疇
疖	癤
疗	療
疟	瘧
疠	癘
疡	瘍
疬	癧
疭	瘲
疮	瘡
疯	瘋
疱	皰
疴	痾
症	症
痈	癰
痉	痙
痒	癢
痖	瘂
痨	癆
痪	瘓
痫	癇
痴	癡
瘅	癉
瘆	瘮
瘗	瘞
瘘	瘻
瘪	癟
瘫	癱
瘾	癮
瘿	癭
癞	癩
癣	癬
癫	癲
皂	皁
皑	皚
皱	皺
皲	皸
盏	盞
盐	鹽
监	監
盖	蓋
盗	盜
盘	盤
眍	瞘
眦	眥
眬	矓
睁	睜
睐	睞
睑	瞼
瞆	瞶
瞒	瞞
瞩	矚
矩	矩
矫	矯
矶	磯
矾	礬
矿	礦
砀	碭
码	碼
砖	磚
砗	硨
砚	硯
砜	碸
砺	礪
砻	礱
砾	礫
础	礎
硁	硜
硕	碩
硖	硤
硗	磽
硙	磑
硚	礄
确	確
硵	磠
硷	礆
碍	礙
碛	磧
碜	磣
碱	鹼
礼	禮
祃	禡
祎	禕
祢	禰
祯	禎
祷	禱
祸	禍
禀	稟
禄	祿
禅	禪
离	離
私	私
秃	禿
秆	稈
秋	秋
种	種
秘	祕
积	積
称	稱
秽	穢
秾	穠
稆	穭
税	稅
稣	穌
稳	穩
穑	穡
穗	穗
穞	穭
穷	窮
窃	竊
窍	竅
窎	窵
窑	窯
窜	竄
窝	窩
窥	窺
窦	竇
窭	窶
竖	豎
竞	競
笃	篤
笋	筍
笔	筆
笕	筧
笺	箋
笼	籠
笾	籩
筑	築
筚	篳
筛	篩
筜	簹
筝	箏
筹	籌
筼	篔
签	籤
筿	篠
简	簡
箓	籙
箦	簀
箧	篋
箨	籜
箩	籮
箪	簞
箫	簫
篑	簣
篓	簍
篮	籃
篯	籛
篱	籬
簖	籪
籁	籟
籴	糴
类	類
籼	秈
粜	糶
粝	糲
粤	粵
粪	糞
粮	糧
粽	糉
糁	糝
糇	餱
糍	餈
系	系
紧	緊
絷	縶
緼	縕
縆	緪
纟	糹
纠	糾
纡	紆
红	紅
纣	紂
纤	纖
纥	紇
约	約
级	級
纨	紈
纩	纊
纪	紀
纫	紉
纬	緯
纭	紜
纮	紘
纯	純
纰	紕
纱	紗
纲	綱
纳	納
纴	紝
纵	縱
纶	綸
纷	紛
纸	紙
纹	紋
纺	紡
纻	紵
纼	紖
纽	紐
纾	紓
线	線
绀	紺
绁	紲
绂	紱
练	練
组	組
绅	紳
细	細
织	織
终	終
绉	縐
绊	絆
绋	紼
绌	絀
绍	紹
绎	繹
经	經
绐	紿
绑	綁
绒	絨
结	結
绔	絝
绕	繞
绖	絰
绗	絎
绘	繪
给	給
绚	絢
绛	絳
络	絡
绝	絕
绞	絞
统	統
绠	綆
绡	綃
绢	絹
绣	繡
绤	綌
绥	綏
绦	絛
继	繼
绨	綈
绩	績
绪	緒
绫	綾
绬	緓
续	續
绮	綺
绯	緋
绰	綽
绱	鞝
绲	緄
绳	繩
维	維
绵	綿
绶	綬
绷	繃
绸	綢
绹	綯
绺	綹
绻	綣
综	綜
绽	綻
绾	綰
绿	綠
缀	綴
缁	緇
缂	緙
缃	緗
缄	緘
缅	緬
缆	纜
缇	緹
缈	緲
缉	緝
缊	縕
缋	繢
缌	緦
缍	綞
缎	緞
缏	緶
缐	線
缑	緱
缒	縋
缓	緩
缔	締
缕	縷
编	編
缗	緡
缘	緣
缙	縉
缚	縛
缛	縟
缜	縝
缝	縫
缞	縗
缟	縞
缠	纏
缡	縭
缢	縊
缣	縑
缤	繽
缥	縹
缦	縵
缧	縲
缨	纓
缩	縮
缪	繆
缫	繅
缬	纈
缭	繚
缮	繕
缯	繒
缰	繮
缱	繾
缲	繰
缳	繯
缴	繳
缵	纘
罂	罌
网	網
罗	羅
罚	罰
罢	罷
罴	羆
羁	羈
羟	羥
羡	羨
群	羣
翘	翹
翙	翽
翚	翬
耢	耮
耧	耬
耸	聳
耻	恥
聂	聶
聋	聾
职	職
聍	聹
联	聯
聩	聵
聪	聰
肃	肅
肠	腸
肤	膚
肮	骯
肴	餚
肾	腎
肿	腫
胀	脹
胁	脅
胄	胄
胆	膽
背	背
胜	勝
胡	胡
胧	朧
胨	腖
胪	臚
胫	脛
胶	膠
脉	脈
脍	膾
脏	髒
脐	臍
脑	腦
脓	膿
脔	臠
脚	腳
脱	脫
脶	腡
脸	臉
腊	臘
腌	醃
腘	膕
腭	齶
腻	膩
腼	靦
腽	膃
腾	騰
膑	臏
膻	羶
臜	臢
致	致
舆	輿
舍	舍
舣	艤
舰	艦
舱	艙
舻	艫
艰	艱
艳	豔
艺	藝
节	節
芈	羋
芗	薌
芜	蕪
芦	蘆
芲	芲
芸	芸
苁	蓯
苇	葦
苈	藶
苋	莧
苌	萇
苍	蒼
苎	苧
苏	蘇
苔	苔
苘	檾
苧	薴
苹	蘋
范	範
茎	莖
茏	蘢
茑	蔦
茔	塋
茕	煢
茧	繭
荆	荊
荐	薦
荙	薘
荚	莢
荛	蕘
荜	蓽
荝	萴
荞	蕎
荟	薈
荠	薺
荡	蕩
荣	榮
荤	葷
荥	滎
荦	犖
荧	熒
荨	蕁
荩	藎
荪	蓀
荫	蔭
荬	蕒
荭	葒
荮	葤
药	藥
莅	蒞
莱	萊
莲	蓮
莳	蒔
莴	萵
莶	薟
获	獲
莸	蕕
莹	瑩
莺	鶯
莼	蓴
萚	蘀
萝	蘿
萤	螢
营	營
萦	縈
萧	蕭
萨	薩
葱	蔥
蒀	蒕
蒇	蕆
蒉	蕢
蒋	蔣
蒌	蔞
蒏	醟
蒙	蒙
蓝	藍
蓟	薊
蓠	蘺
蓣	蕷
蓥	鎣
蓦	驀
蔂	虆
蔑	蔑
蔷	薔
蔹	蘞
蔺	藺
蔼	藹
蕰	薀
蕲	蘄
蕴	蘊
薮	藪
藓	蘚
藴	蘊
蘖	櫱
虏	虜
虑	慮
虚	虛
虫	蟲
虬	虯
虮	蟣
虱	蝨
虽	雖
虾	蝦
虿	蠆
蚀	蝕
蚁	蟻
蚂	螞
蚃	蠁
蚕	蠶
蚝	蠔
蚬	蜆
蛊	蠱
蛎	蠣
蛏	蟶
蛮	蠻
蛰	蟄
蛱	蛺
蛲	蟯
蛳	螄
蛴	蠐
蜕	蛻
蜗	蝸
蜡	蠟
蝇	蠅
蝈	蟈
蝉	蟬
蝎	蠍
蝼	螻
蝾	蠑
螀	螿
螨	蟎
蟏	蠨
衅	釁
衔	銜
补	補
表	表
衬	襯
衮	袞
袄	襖
袅	嫋
袆	褘
袜	襪
袭	襲
袯	襏
装	裝
裆	襠
裈	褌
裢	褳
裣	襝
裤	褲
裥	襉
褛	褸
褴	襤
襕	襴
见	見
观	觀
觃	覎
规	規
觅	覓
视	視
觇	覘
览	覽
觉	覺
觊	覬
觋	覡
觌	覿
觍	覥
觎	覦
觏	覯
觐	覲
觑	覷
觞	觴
触	觸
觯	觶
訚	誾
詟	讋
誉	譽
誊	謄
讠	訁
计	計
订	訂
讣	訃
认	認
讥	譏
讦	訐
讧	訌
讨	討
让	讓
讪	訕
讫	訖
讬	託
训	訓
议	議
讯	訊
记	記
讱	訒
讲	講
讳	諱
讴	謳
讵	詎
讶	訝
讷	訥
许	許
讹	訛
论	論
讻	訩
讼	訟
讽	諷
设	設
访	訪
诀	訣
证	證
诂	詁
诃	訶
评	評
诅	詛
识	識
诇	詗
诈	詐
诉	訴
诊	診
诋	詆
诌	謅
词	詞
诎	詘
诏	詔
诐	詖
译	譯
诒	詒
诓	誆
诔	誄
试	試
诖	詿
诗	詩
诘	詰
诙	詼
诚	誠
诛	誅
诜	詵
话	話
诞	誕
诟	詬
诠	詮
诡	詭
询	詢
诣	詣
诤	諍
该	該
详	詳
诧	詫
诨	諢
诩	詡
诪	譸
诫	誡
诬	誣
语	語
诮	誚
误	誤
诰	誥
诱	誘
诲	誨
诳	誑
说	說
诵	誦
诶	誒
请	請
诸	諸
诹	諏
诺	諾
读	讀
诼	諑
诽	誹
课	課
诿	諉
谀	諛
谁	誰
谂	諗
调	調
谄	諂
谅	諒
谆	諄
谇	誶
谈	談
谉	讅
谊	誼
谋	謀
谌	諶
谍	諜
谎	謊
谏	諫
谐	諧
谑	謔
谒	謁
谓	謂
谔	諤
谕	諭
谖	諼
谗	讒
谘	諮
谙	諳
谚	諺
谛	諦
谜	謎
谝	諞
谞	諝
谟	謨
谠	讜
谡	謖
谢	謝
谣	謠
谤	謗
谥	諡
谦	謙
谧	謐
谨	謹
谩	謾
谪	謫
谫	譾
谬	謬
谭	譚
谮	譖
谯	譙
谰	讕
谱	譜
谲	譎
谳	讞
谴	譴
谵	譫
谶	讖
谷	谷
豮	豶
贝	貝
贞	貞
负	負
贠	貟
贡	貢
财	財
责	責
贤	賢
败	敗
账	賬
货	貨
质	質
贩	販
贪	貪
贫	貧
贬	貶
购	購
贮	貯
贯	貫
贰	貳
贱	賤
贲	賁
贳	貰
贴	貼
贵	貴
贶	貺
贷	貸
贸	貿
费	費
贺	賀
贻	貽
贼	賊
贽	贄
贾	賈
贿	賄
赀	貲
赁	賃
赂	賂
赃	贓
资	資
赅	賅
赆	贐
赇	賕
赈	賑
赉	賚
赊	賒
赋	賦
赌	賭
赍	齎
赎	贖
赏	賞
赐	賜
赑	贔
赒	賙
赓	賡
赔	賠
赕	賧
赖	賴
赗	賵
赘	贅
赙	賻
赚	賺
赛	賽
赜	賾
赝	贗
赞	贊
赟	贇
赠	贈
赡	贍
赢	贏
赣	贛
赪	赬
赵	趙
赶	趕
趋	趨
趱	趲
趸	躉
跃	躍
跄	蹌
跞	躒
践	踐
跶	躂
跷	蹺
跸	蹕
跹	躚
跻	躋
踌	躊
踪	蹤
踬	躓
踯	躑
蹑	躡
蹒	蹣
蹰	躕
蹿	躥
躏	躪
躜	躦
躯	軀
輼	轀
车	車
轧	軋
轨	軌
轩	軒
轪	軑
轫	軔
转	轉
轭	軛
轮	輪
软	軟
轰	轟
轱	軲
轲	軻
轳	轤
轴	軸
轵	軹
轶	軼
轷	軤
轸	軫
轹	轢
轺	軺
轻	輕
轼	軾
载	載
轾	輊
轿	轎
辀	輈
辁	輇
辂	輅
较	較
辄	輒
辅	輔
辆	輛
辇	輦
辈	輩
辉	輝
辊	輥
辋	輞
辌	輬
辍	輟
辎	輜
辏	輳
辐	輻
辑	輯
辒	轀
输	輸
辔	轡
辕	轅
辖	轄
辗	輾
辘	轆
辙	轍
辚	轔
辞	辭
辟	闢
辩	辯
辫	辮
边	邊
辽	遼
达	達
迁	遷
过	過
迈	邁
运	運
还	還
这	這
进	進
远	遠
违	違
连	連
迟	遲
迩	邇
迳	逕
迹	跡
适	適
选	選
逊	遜
递	遞
逦	邐
逻	邏
遗	遺
遥	遙
邓	鄧
邝	鄺
邬	鄔
邮	郵
邹	鄒
邺	鄴
邻	鄰
郁	鬱
郏	郟
郐	鄶
郑	鄭
郓	鄆
郦	酈
郧	鄖
郸	鄲
酂	酇
酝	醞
酦	醱
酱	醬
酸	酸
酽	釅
酾	釃
酿	釀
醖	醞
采	採
释	釋
里	裏
鉴	鑑
銮	鑾
錾	鏨
钅	釒
钆	釓
钇	釔
针	針
钉	釘
钊	釗
钋	釙
钌	釕
钍	釷
钎	釺
钏	釧
钐	釤
钑	鈒
钒	釩
钓	釣
钔	鍆
钕	釹
钖	鍚
钗	釵
钘	鈃
钙	鈣
钚	鈈
钛	鈦
钜	鉅
钝	鈍
钞	鈔
钟	鍾
钠	鈉
钡	鋇
钢	鋼
钣	鈑
钤	鈐
钥	鑰
钦	欽
钧	鈞
钨	鎢
钩	鉤
钪	鈧
钫	鈁
钬	鈥
钭	鈄
钮	鈕
钯	鈀
钰	鈺
钱	錢
钲	鉦
钳	鉗
钴	鈷
钵	鉢
钶	鈳
钷	鉕
钸	鈽
钹	鈸
钺	鉞
钻	鑽
钼	鉬
钽	鉭
钾	鉀
钿	鈿
铀	鈾
铁	鐵
铂	鉑
铃	鈴
铄	鑠
铅	鉛
铆	鉚
铇	鉋
铈	鈰
铉	鉉
铊	鉈
铋	鉍
铌	鈮
铍	鈹
铎	鐸
铏	鉶
铐	銬
铑	銠
铒	鉺
铓	鋩
铔	錏
铕	銪
铖	鋮
铗	鋏
铘	鋣
铙	鐃
铚	銍
铛	鐺
铜	銅
铝	鋁
铞	銱
铟	銦
铠	鎧
铡	鍘
铢	銖
铣	銑
铤	鋌
铥	銩
铦	銛
铧	鏵
铨	銓
铩	鎩
铪	鉿
铫	銚
铬	鉻
铭	銘
铮	錚
铯	銫
铰	鉸
铱	銥
铲	鏟
铳	銃
铴	鐋
铵	銨
银	銀
铷	銣
铸	鑄
铹	鐒
铺	鋪
铻	鋙
铼	錸
铽	鋱
链	鏈
铿	鏗
销	銷
锁	鎖
锂	鋰
锃	鋥
锄	鋤
锅	鍋
锆	鋯
锇	鋨
锈	鏽
锉	銼
锊	鋝
锋	鋒
锌	鋅
锍	鋶
锎	鐦
锏	鐗
锐	銳
锑	銻
锒	鋃
锓	鋟
锔	鋦
锕	錒
锖	錆
锗	鍺
锘	鍩
错	錯
锚	錨
锛	錛
锜	錡
锝	鍀
锞	錁
锟	錕
锠	錩
锡	錫
锢	錮
锣	鑼
锤	錘
锥	錐
锦	錦
锧	鑕
锨	杴
锩	錈
锪	鍃
锫	錇
锬	錟
锭	錠
键	鍵
锯	鋸
锰	錳
锱	錙
锲	鍥
锳	鍈
锴	鍇
锵	鏘
锶	鍶
锷	鍔
锸	鍤
锹	鍬
锺	鍾
锻	鍛
锼	鎪
锽	鍠
锾	鍰
锿	鎄
镀	鍍
镁	鎂
镂	鏤
镃	鎡
镄	鐨
镅	鎇
镆	鏌
镇	鎮
镈	鎛
镉	鎘
镊	鑷
镋	钂
镌	鐫
镍	鎳
镎	鎿
镏	鎦
镐	鎬
镑	鎊
镒	鎰
镓	鎵
镔	鑌
镕	鎔
镖	鏢
镗	鏜
镘	鏝
镙	鏍
镚	鏰
镛	鏞
镜	鏡
镝	鏑
镞	鏃
镟	鏇
镠	鏐
镡	鐔
镢	钁
镣	鐐
镤	鏷
镥	鑥
镦	鐓
镧	鑭
镨	鐠
镩	鑹
镪	鏹
镫	鐙
镬	鑊
镭	鐳
镮	鐶
镯	鐲
镰	鐮
镱	鐿
镲	鑔
镳	鑣
镴	鑞
镵	鑱
镶	鑲
长	長
门	門
闩	閂
闪	閃
闫	閆
闬	閈
闭	閉
问	問
闯	闖
闰	閏
闱	闈
闲	閒
闳	閎
间	間
闵	閔
闶	閌
闷	悶
闸	閘
闹	鬧
闺	閨
闻	聞
闼	闥
闽	閩
闾	閭
闿	闓
阀	閥
阁	閣
阂	閡
阃	閫
阄	鬮
阅	閱
阆	閬
阇	闍
阈	閾
阉	閹
阊	閶
阋	鬩
阌	閿
阍	閽
阎	閻
阏	閼
阐	闡
阑	闌
阒	闃
阓	闠
阔	闊
阕	闋
阖	闔
阗	闐
阘	闒
阙	闕
阚	闞
阛	闤
队	隊
阳	陽
阴	陰
阵	陣
阶	階
际	際
陆	陸
陇	隴
陈	陳
陉	陘
陕	陝
陦	隯
陧	隉
陨	隕
险	險
随	隨
隐	隱
隶	隸
隽	雋
难	難
雇	僱
雏	雛
雕	雕
雠	讎
雳	靂
雾	霧
霁	霽
霉	黴
霡	霢
霭	靄
靓	靚
靔	靝
静	靜
面	面
靥	靨
鞑	韃
鞒	鞽
鞯	韉
鞲	韝
韦	韋
韧	韌
韨	韍
韩	韓
韪	韙
韫	韞
韬	韜
韵	韻
页	頁
顶	頂
顷	頃
顸	頇
项	項
顺	順
须	須
顼	頊
顽	頑
顾	顧
顿	頓
颀	頎
颁	頒
颂	頌
颃	頏
预	預
颅	顱
领	領
颇	頗
颈	頸
颉	頡
颊	頰
颋	頲
颌	頜
颍	潁
颎	熲
颏	頦
颐	頤
频	頻
颒	頮
颓	頹
颔	頷
颕	頴
颖	穎
颗	顆
题	題
颙	顒
颚	顎
颛	顓
颜	顏
额	額
颞	顳
颟	顢
颠	顛
颡	顙
颢	顥
颣	纇
颤	顫
颥	顬
颦	顰
颧	顴
风	風
飏	颺
飐	颭
飑	颮
飒	颯
飓	颶
飔	颸
飕	颼
飖	颻
飗	飀
飘	飄
飙	飆
飚	飈
飞	飛
飨	饗
餍	饜
饣	飠
饤	飣
饥	飢
饦	飥
饧	餳
饨	飩
饩	餼
饪	飪
饫	飫
饬	飭
饭	飯
饮	飲
饯	餞
饰	飾
饱	飽
饲	飼
饳	飿
饴	飴
饵	餌
饶	饒
饷	餉
饸	餄
饹	餎
饺	餃
饻	餏
饼	餅
饽	餑
饾	餖
饿	餓
馀	餘
馁	餒
馂	餕
馃	餜
馄	餛
馅	餡
馆	館
馇	餷
馈	饋
馉	餶
馊	餿
馋	饞
馌	饁
馍	饃
馎	餺
馏	餾
馐	饈
馑	饉
馒	饅
馓	饊
馔	饌
馕	饢
马	馬
驭	馭
驮	馱
驯	馴
驰	馳
驱	驅
驲	馹
驳	駁
驴	驢
驵	駔
驶	駛
驷	駟
驸	駙
驹	駒
驺	騶
驻	駐
驼	駝
驽	駑
驾	駕
驿	驛
骀	駘
骁	驍
骂	罵
骃	駰
骄	驕
骅	驊
骆	駱
骇	駭
骈	駢
骉	驫
骊	驪
骋	騁
验	驗
骍	騂
骎	駸
骏	駿
骐	騏
骑	騎
骒	騍
骓	騅
骔	騌
骕	驌
骖	驂
骗	騙
骘	騭
骙	騤
骚	騷
骛	騖
骜	驁
骝	騮
骞	騫
骟	騸
骠	驃
骡	騾
骢	驄
骣	驏
骤	驟
骥	驥
骦	驦
骧	驤
髅	髏
髋	髖
髌	髕
鬓	鬢
鬶	鬹
魇	魘
魉	魎
鱼	魚
鱽	魛
鱾	魢
鱿	魷
鲀	魨
鲁	魯
鲂	魴
鲃	䰾
鲄	魺
鲅	鮁
鲆	鮃
鲇	鮎
鲈	鱸
鲉	鮋
鲊	鮓
鲋	鮒
鲌	鮊
鲍	鮑
鲎	鱟
鲏	鮍
鲐	鮐
鲑	鮭
鲒	鮚
鲓	鮳
鲔	鮪
鲕	鮞
鲖	鮦
鲗	鰂
鲘	鮜
鲙	鱠
鲚	鱭
鲛	鮫
鲜	鮮
鲝	鮺
鲞	鯗
鲟	鱘
鲠	鯁
鲡	鱺
鲢	鰱
鲣	鰹
鲤	鯉
鲥	鰣
鲦	鰷
鲧	鯀
鲨	鯊
鲩	鯇
鲪	鮶
鲫	鯽
鲬	鯒
鲭	鯖
鲮	鯪
鲯	鯕
鲰	鯫
鲱	鯡
鲲	鯤
鲳	鯧
鲴	鯝
鲵	鯢
鲶	鮎
鲷	鯛
鲸	鯨
鲹	鰺
鲺	鯴
鲻	鯔
鲼	鱝
鲽	鰈
鲾	鰏
鲿	鱨
鳀	鯷
鳁	鰮
鳂	鰃
鳃	鰓
鳄	鱷
鳅	鰍
鳆	鰒
鳇	鰉
鳈	鰁
鳉	鱂
鳊	鯿
鳋	鰠
鳌	鰲
鳍	鰭
鳎	鰨
鳏	鰥
鳐	鰩
鳑	鰟
鳒	鰜
鳓	鰳
鳔	鰾
鳕	鱈
鳖	鱉
鳗	鰻
鳘	鰵
鳙	鱅
鳚	䲁
鳛	鰼
鳜	鱖
鳝	鱔
鳞	鱗
鳟	鱒
鳠	鱯
鳡	鱤
鳢	鱧
鳣	鱣
鳤	䲘
鸟	鳥
鸠	鳩
鸡	雞
鸢	鳶
鸣	鳴
鸤	鳲
鸥	鷗
鸦	鴉
鸧	鶬
鸨	鴇
鸩	鴆
鸪	鴣
鸫	鶇
鸬	鸕
鸭	鴨
鸮	鴞
鸯	鴦
鸰	鴒
鸱	鴟
鸲	鴝
鸳	鴛
鸴	鷽
鸵	鴕
鸶	鷥
鸷	鷙
鸸	鴯
鸹	鴰
鸺	鵂
鸻	鴴
鸼	鵃
鸽	鴿
鸾	鸞
鸿	鴻
鹀	鵐
鹁	鵓
鹂	鸝
鹃	鵑
鹄	鵠
鹅	鵝
鹆	鵒
鹇	鷳
鹈	鵜
鹉	鵡
鹊	鵲
鹋	鶓
鹌	鵪
鹍	鵾
鹎	鵯
鹏	鵬
鹐	鵮
鹑	鶉
鹒	鶊
鹓	鵷
鹔	鷫
鹕	鶘
鹖	鶡
鹗	鶚
鹘	鶻
鹙	鶖
鹚	鶿
鹛	鶥
鹜	鶩
鹝	鷊
鹞	鷂
鹟	鶲
鹠	鶹
鹡	鶺
鹢	鷁
鹣	鶼
鹤	鶴
鹥	鷖
鹦	鸚
鹧	鷓
鹨	鷚
鹩	鷯
鹪	鷦
鹫	鷲
鹬	鷸
鹭	鷺
鹮	䴉
鹯	鸇
鹰	鷹
鹱	鸌
鹲	鸏
鹳	鸛
鹴	鸘
鹾	鹺
麦	麥
麸	麩
麹	麴
麺	麪
麽	麼
黄	黃
黉	黌
黡	黶
黩	黷
黪	黲
黾	黽
鼋	黿
鼌	鼂
鼍	鼉
鼗	鞀
鼹	鼴
齄	齇
齐	齊
齑	齏
齿	齒
龀	齔
龁	齕
龂	齗
龃	齟
龄	齡
龅	齙
龆	齠
龇	齜
龈	齦
龉	齬
龊	齪
龋	齲
龌	齷
龙	龍
龚	龔
龛	龕
龟	龜
鿎	䃮
鿏	䥑
鿒	鿓
鿔	鎶
𠀾	𠁞
𠆲	儣
𠆿	𠌥
𠇹	俓
𠉂	㒓
𠉗	𠏢
𠊉	𣍐
𠋆	儭
𠚳	𠠎
𠛅	剾
𠛆	𠞆
𠛾	𪟖
𠡠	勑
𠮶	嗰
𠯟	哯
𠯠	噅
𠰱	㘉
𠰷	嚧
𠱞	囃
𠲥	𡅏
𠴛	𡃕
𠴢	𡄔
𠵸	𡄣
𠵾	㗲
𡋀	𡓾
𡋗	𡑭
𡋤	壗
𡍣	𡔖
𡒄	壈
𡝠	㜷
𡞋	㜗
𡞱	㜢
𡠟	孎
𡥧	孻
𡭜	𡮉
𡭬	𡮣
𡳃	𡳳
𡳒	𦘧
𡶴	嵼
𡸃	𡽗
𡺃	嶈
𡺄	嶘
𢋈	㢝
𢗓	㦛
𢘙	𢤱
𢘝	𢣚
𢘞	𢣭
𢙏	愻
𢙐	憹
𢙑	𢠼
𢙒	憢
𢙓	懀
𢛯	㦎
𢠁	懎
𢢐	𤢻
𢧐	戰
𢫊	𢷮
𢫞	𢶫
𢫬	摋
𢬍	擫
𢬦	𢹿
𢭏	擣
𢽾	斅
𣃁	斸
𣆐	曥
𣈣	𣋋
𣍨	𦢈
𣍯	腪
𣍰	脥
𣎑	臗
𣏢	槫
𣐕	桱
𣐤	欍
𣑶	𣠲
𣒌	楇
𣓿	橯
𣔌	樤
𣗊	樠
𣗋	欓
𣗙	㰙
𣘐	㯤
𣘓	𣞻
𣘴	檭
𣘷	𣝕
𣚚	欘
𣞎	𣠩
𣨼	殢
𣭤	𣯴
𣯣	𣯩
𣱝	氭
𣲗	湋
𣲘	潕
𣳆	㵗
𣶩	澅
𣶫	𣿉
𣶭	𪷓
𣷷	𤅶
𣸣	濆
𣺼	灙
𣺽	𤁣
𣽷	瀃
𤆡	熓
𤆢	㷍
𤇃	爄
𤇄	熌
𤇭	爖
𤇹	熚
𤈶	熉
𤈷	㷿
𤊀	𤒎
𤊰	𤓩
𤋏	熡
𤎺	㸇
𤎻	𤑳
𤙯	𤛮
𤝢	𤢟
𤞃	獩
𤞤	玁
𤠋	㺏
𤦀	瓕
𤩽	瓛
𤳄	𤳸
𤶊	癐
𤶧	𤸫
𤻊	㿗
𤽯	㿧
𤾀	皟
𤿲	麬
𥁢	䀉
𥅘	𥌃
𥅴	䀹
𥅿	𥊝
𥆧	瞤
𥇢	䁪
𥎝	䂎
𥐟	礒
𥐯	𥖅
𥐰	𥕥
𥐻	碙
𥞦	𥞵
𥧂	𥨐
𥩟	竚
𥩺	𥪂
𥫣	籅
𥬀	䉙
𥬞	籋
𥬠	篘
𥭉	𥵊
𥮋	𥸠
𥮜	䉲
𥮾	篸
𥱔	𥵃
𥹥	𥼽
𥺅	䊭
𥺇	𥽖
𦈈	𥿊
𦈉	緷
𦈋	綇
𦈌	綀
𦈎	繟
𦈏	緍
𦈐	縺
𦈑	緸
𦈒	𦂅
𦈓	䋿
𦈔	縎
𦈕	緰
𦈖	䌈
𦈗	𦃄
𦈘	䌋
𦈙	䌰
𦈚	縬
𦈛	繓
𦈜	䌖
𦈝	繏
𦈞	䌟
𦈟	䌝
𦈠	䌥
𦈡	繻
𦍠	䍽
𦛨	朥
𦝼	膢
𦟗	𦣎
𦨩	𦪽
𦰏	蓧
𦰴	䕳
𦶟	爇
𦶻	𦾟
𦻕	蘟
𦼖	檾
𧉐	𧕟
𧉞	䗿
𧌥	𧎈
𧏖	蠙
𧏗	蠀
𧑏	蠾
𧒭	𧔥
𧜭	䙱
𧝝	襰
𧝧	𧟀
𧮪	詀
𧳕	𧳟
𧹑	䞈
𧹒	買
𧹓	𧶔
𧹔	賬
𧹕	䝻
𧹖	賟
𧹗	贃
𧿈	𨇁
𨀁	躘
𨀱	𨄣
𨁴	𨅍
𨂺	𨈊
𨄄	𨈌
𨅛	䠱
𨅫	𨇞
𨅬	躝
𨉗	軉
𨐅	軗
𨐆	𨊻
𨐇	𨏠
𨐈	輄
𨐉	𨎮
𨐊	𨏥
𨑹	䢨
𨟳	𨣞
𨠨	𨣧
𨡙	𨢿
𨡺	𨣈
𨤰	𨤻
𨰾	鎷
𨰿	釳
𨱀	𨥛
𨱁	鈠
𨱂	鈋
𨱃	鈲
𨱄	鈯
𨱅	鉁
𨱆	龯
𨱇	銶
𨱈	鋉
𨱉	鍄
𨱊	𨧱
𨱋	錂
𨱌	鏆
𨱍	鎯
𨱎	鍮
𨱏	鎝
𨱐	𨫒
𨱑	鐄
𨱒	鏉
𨱓	鐎
𨱔	鐏
𨱕	𨮂
𨱖	䥩
𨷿	䦳
𨸀	𨳕
𨸁	𨳑
𨸂	閍
𨸃	閐
𨸄	䦘
𨸅	𨴗
𨸆	𨵩
𨸇	𨵸
𨸉	𨶀
𨸊	𨶏
𨸋	𨶲
𨸌	𨶮
𨸎	𨷲
𨸘	𨽏
𨸟	䧢
𩏼	䪏
𩏽	𩏪
𩏾	𩎢
𩏿	䪘
𩐀	䪗
𩓋	顂
𩖕	𩓣
𩖖	顃
𩖗	䫴
𩙥	颰
𩙦	𩗀
𩙧	䬞
𩙨	𩘹
𩙩	𩘀
𩙪	颷
𩙫	颾
𩙬	𩘺
𩙭	𩘝
𩙮	䬘
𩙯	䬝
𩙰	𩙈
𩟿	𩚛
𩠀	𩚥
𩠁	𩚵
𩠂	𩛆
𩠃	𩛩
𩠅	𩟐
𩠆	𩜦
𩠇	䭀
𩠈	䭃
𩠉	𩜇
𩠊	𩜵
𩠋	𩝔
𩠌	餸
𩠎	𩞄
𩠏	𩞦
𩠠	𩠴
𩡖	𩡣
𩧦	𩡺
𩧨	駎
𩧩	𩤊
𩧪	䮾
𩧫	駚
𩧬	𩢡
𩧭	䭿
𩧮	𩢾
𩧯	驋
𩧰	䮝
𩧱	𩥉
𩧲	駧
𩧳	𩢸
𩧴	駩
𩧵	𩢴
𩧶	𩣏
𩧸	𩣫
𩧺	駶
𩧻	𩣵
𩧼	𩣺
𩧿	䮠
𩨀	騔
𩨁	䮞
𩨂	驄
𩨃	騝
𩨄	騪
𩨅	𩤸
𩨆	𩤙
𩨇	䮫
𩨈	騟
𩨉	𩤲
𩨊	騚
𩨋	𩥄
𩨌	𩥑
𩨍	𩥇
𩨎	龭
𩨏	䮳
𩨐	𩧆
𩩈	䯤
𩬣	𩭙
𩬤	𩰀
𩭹	鬖
𩯒	𩯳
𩰰	𩰹
𩲒	𩳤
𩴌	𩴵
𩽹	魥
𩽺	𩵩
𩽻	𩵹
𩽼	鯶
𩽽	𩶱
𩽾	鮟
𩽿	𩶰
𩾀	鮕
𩾁	鯄
𩾂	䲖
𩾃	鮸
𩾄	𩷰
𩾅	𩸃
𩾆	𩸦
𩾇	鯱
𩾈	䱙
𩾊	䱬
𩾋	䱰
𩾌	鱇
𩾎	𩽇
𪉂	䲰
𪉃	鳼
𪉄	𩿪
𪉅	𪀦
𪉆	鴲
𪉈	鴜
𪉉	𪁈
𪉊	鷨
𪉋	𪀾
𪉌	𪁖
𪉍	鵚
𪉎	𪂆
𪉏	𪃏
𪉐	𪃍
𪉑	鷔
𪉒	𪄕
𪉓	𪈼
𪉔	𪄆
𪉕	𪇳
𪎈	䴬
𪎉	麲
𪎊	麨
𪎋	䴴
𪎌	麳
𪎍	𪋿
𪑅	䵳
𪔭	𪔵
𪚏	𪘀
𪚐	𪘯
𪜎	𠿕
𪞝	凙
𪟎	㔋
𪟝	勣
𪠀	𧷎
𪠟	㓄
𪠡	𠬙
𪠳	唓
𪠵	㖮
𪠸	嚛
𪠺	𠽃
𪠽	噹
𪡀	嘺
𪡃	嘪
𪡋	噞
𪡏	嗹
𪡛	㗿
𪡞	嘳
𪡺	𡃄
𪢌	㘓
𪢐	𡃤
𪢒	𡂡
𪢕	嚽
𪢖	𡅯
𪢠	囒
𪢮	圞
𪢸	墲
𪣆	埬
𪣒	堚
𪣻	塿
𪤄	𡓁
𪤚	壣
𪥠	𧹈
𪥫	孇
𪥰	嬣
𪥿	嬻
𪧀	孾
𪧘	寠
𪨊	㞞
𪨗	屩
𪨧	崙
𪨩	𡸗
𪨶	輋
𪨷	巗
𪨹	𡹬
𪩇	㟺
𪩎	巊
𪩘	巘
𪩛	𡿖
𪩷	幝
𪩸	幩
𪪏	廬
𪪑	㢗
𪪞	廧
𪪴	𢍰
𪪼	彃
𪫌	徿
𪫡	𢤩
𪫷	㦞
𪫺	憸
𪬚	𢣐
𪬯	𢤿
𪭝	𢯷
𪭢	摐
𪭧	擟
𪭯	𢶒
𪭵	掚
𪭾	撊
𪮃	㨻
𪮋	㩋
𪮖	撧
𪮳	𢺳
𪮶	攋
𪯋	㪎
𪰶	曊
𪱥	膹
𪱷	梖
𪲎	櫅
𪲔	欐
𪲛	檵
𪲮	櫠
𪳍	欇
𪳗	𣜬
𪴙	欑
𪵑	毊
𪵣	霼
𪵱	濿
𪶄	溡
𪶒	𤄷
𪶮	𣽏
𪷍	㵾
𪷽	灒
𪸕	熂
𪸩	煇
𪹀	𤑹
𪹠	𤓌
𪹳	爥
𪹹	𤒻
𪺣	𤘀
𪺪	𤜆
𪺭	犞
𪺷	獊
𪺸	𤠮
𪺻	㺜
𪺽	猌
𪻐	瑽
𪻨	瓄
𪻲	瑻
𪻺	璝
𪼋	㻶
𪼴	𤬅
𪽈	畼
𪽝	𤳷
𪽪	痮
𪽭	𤷃
𪽮	㿖
𪽴	𤺔
𪽷	瘱
𪾔	盨
𪾢	睍
𪾣	眝
𪾦	矑
𪾸	矉
𪿊	𥏝
𪿞	𥖲
𪿫	礮
𪿵	𥗇
𫀌	𥜰
𫀓	𥜐
𫀨	䅐
𫀬	䅳
𫀮	𥢷
𫁂	䆉
𫁟	竱
𫁡	鴗
𫁱	𥶽
𫁲	䉑
𫁳	𥯤
𫁷	䉶
𫁺	𥴼
𫂃	簢
𫂆	簂
𫂈	䉬
𫂖	𥴨
𫂿	𥻦
𫃗	𩏷
𫄙	糺
𫄚	䊺
𫄛	紟
𫄜	䋃
𫄝	𥾯
𫄞	䋔
𫄟	絁
𫄠	絙
𫄡	絧
𫄢	絥
𫄣	繷
𫄤	繨
𫄥	纚
𫄦	𦀖
𫄧	綖
𫄨	絺
𫄩	䋦
𫄪	𦅇
𫄫	綟
𫄬	緤
𫄭	緮
𫄮	䋼
𫄯	𦃩
𫄰	縍
𫄱	繬
𫄲	縸
𫄳	縰
𫄴	繂
𫄵	𦅈
𫄶	繈
𫄷	繶
𫄸	纁
𫄹	纗
𫅅	䍤
𫅗	羵
𫅥	𦒀
𫅭	䎙
𫅼	𦔖
𫆏	聻
𫆝	𦟼
𫆫	𦡝
𫇘	𦧺
𫇛	艣
𫇪	𦱌
𫇭	蔿
𫇴	蒭
𫇽	蕽
𫈉	蕳
𫈎	葝
𫈟	蔯
𫈵	蕝
𫉁	薆
𫉄	藷
𫊪	䗅
𫊮	蠦
𫊸	蟜
𫊹	𧒯
𫊻	蟳
𫋇	蟂
𫋌	蟘
𫋲	䙔
𫋷	襗
𫋹	襓
𫋻	襘
𫌀	襀
𫌇	襵
𫌋	𧞫
𫌨	覼
𫌪	覛
𫌫	𧡴
𫌬	𧢄
𫌭	覹
𫌯	䚩
𫍐	𧭹
𫍙	訑
𫍚	訞
𫍛	訜
𫍜	詓
𫍝	諫
𫍞	𧦝
𫍟	𧦧
𫍠	䛄
𫍡	詑
𫍢	譊
𫍣	詷
𫍤	譑
𫍥	誂
𫍦	譨
𫍧	誺
𫍨	誫
𫍩	諣
𫍪	誋
𫍫	䛳
𫍬	誷
𫍭	𧩕
𫍮	誳
𫍯	諴
𫍰	諰
𫍱	諯
𫍲	謏
𫍳	諥
𫍴	謱
𫍵	謸
𫍶	𧩼
𫍷	謉
𫍸	謆
𫍹	謯
𫍺	𧫝
𫍻	譆
𫍼	𧬤
𫍽	譞
𫍾	𧭈
𫍿	譾
𫎆	豵
𫎌	貗
𫎦	贚
𫎧	䝭
𫎨	𧸘
𫎩	賝
𫎪	䞋
𫎫	贉
𫎬	贑
𫎭	䞓
𫎱	䟐
𫎳	䟆
𫎸	𧽯
𫎺	䟃
𫏃	䠆
𫏆	蹳
𫏋	蹻
𫏌	𨂐
𫏐	蹔
𫏑	𨇽
𫏕	𨆪
𫏞	𨇰
𫏨	𨇤
𫐄	軏
𫐅	軕
𫐆	轣
𫐇	軜
𫐈	軷
𫐉	軨
𫐊	軬
𫐋	𨎌
𫐌	軿
𫐍	𨌈
𫐎	輢
𫐏	輖
𫐐	輗
𫐑	輨
𫐒	輷
𫐓	輮
𫐔	𨍰
𫐕	轊
𫐖	轇
𫐗	轐
𫐘	轗
𫐙	轠
𫐷	遱
𫑘	鄟
𫑡	鄳
𫑷	醶
𫓥	釟
𫓦	釨
𫓧	鈇
𫓨	鈛
𫓩	鏦
𫓪	鈆
𫓫	𨥟
𫓬	鉔
𫓭	鉠
𫓮	𨪕
𫓯	銈
𫓰	銊
𫓱	鐈
𫓲	銁
𫓳	𨰋
𫓴	鉾
𫓵	鋠
𫓶	鋗
𫓷	𫒡
𫓸	錽
𫓹	錤
𫓺	鐪
𫓻	錜
𫓼	𨨛
𫓽	錝
𫓾	錥
𫓿	𨨢
𫔀	鍊
𫔁	鐼
𫔂	鍉
𫔃	𨰲
𫔄	鍒
𫔅	鎍
𫔆	䥯
𫔇	鎞
𫔈	鎙
𫔉	𨰃
𫔊	鏥
𫔋	䥗
𫔌	鏾
𫔍	鐇
𫔎	鐍
𫔏	𨬖
𫔐	𨭸
𫔑	𨭖
𫔒	𨮳
𫔓	𨯟
𫔔	鑴
𫔕	𨰥
𫔖	𨲳
𫔭	開
𫔮	閒
𫔯	閗
𫔰	閞
𫔲	𨴹
𫔴	閵
𫔵	䦯
𫔶	闑
𫔽	𨼳
𫕚	𩀨
𫕥	霣
𫕨	𩅙
𫖃	靧
𫖅	䪊
𫖇	鞾
𫖑	𩎖
𫖒	韠
𫖓	𩏂
𫖔	韛
𫖕	韝
𫖖	𩏠
𫖪	𩑔
𫖫	䪴
𫖬	䪾
𫖭	𩒎
𫖮	顗
𫖯	頫
𫖰	䫂
𫖱	䫀
𫖲	䫟
𫖳	頵
𫖴	𩔳
𫖵	𩓥
𫖶	顅
𫖷	𩔑
𫖸	願
𫖹	顣
𫖺	䫶
𫗇	䫻
𫗈	𩗓
𫗉	𩗴
𫗊	䬓
𫗋	飋
𫗚	𩟗
𫗞	飦
𫗟	䬧
𫗠	餦
𫗡	𩚩
𫗢	飵
𫗣	飶
𫗤	𩛌
𫗥	餫
𫗦	餔
𫗧	餗
𫗨	𩛡
𫗩	饠
𫗪	餧
𫗫	餬
𫗬	餪
𫗭	餵
𫗮	餭
𫗯	餱
𫗰	䭔
𫗱	䭑
𫗳	𩝽
𫗴	饘
𫗵	饟
𫘛	馯
𫘜	馼
𫘝	駃
𫘞	駞
𫘟	駊
𫘠	駤
𫘡	駫
𫘣	駻
𫘤	騃
𫘥	騉
𫘦	騊
𫘧	騄
𫘨	騠
𫘩	騜
𫘪	騵
𫘫	騴
𫘬	騱
𫘭	騻
𫘮	䮰
𫘯	驓
𫘰	驙
𫘱	驨
𫘽	鬠
𫙂	𩯁
𫚈	鱮
𫚉	魟
𫚊	鰑
𫚋	鱄
𫚌	魦
𫚍	魵
𫚎	𩶁
𫚏	䱁
𫚐	䱀
𫚑	鮅
𫚒	鮄
𫚓	鮤
𫚔	鮰
𫚕	鰤
𫚖	鮆
𫚗	鮯
𫚘	𩻮
𫚙	鯆
𫚚	鮿
𫚛	鮵
𫚜	䲅
𫚝	𩸄
𫚞	鯬
𫚟	𩸡
𫚠	䱧
𫚡	鯞
𫚢	鰋
𫚣	鯾
𫚤	鰦
𫚥	鰕
𫚦	鰫
𫚧	鰽
𫚨	𩻗
𫚩	𩻬
𫚪	鱊
𫚫	鱢
𫚬	𩼶
𫚭	鱲
𫛚	鳽
𫛛	鳷
𫛜	鴀
𫛝	鴅
𫛞	鴃
𫛟	鸗
𫛠	𩿤
𫛡	鴔
𫛢	鸋
𫛣	鴥
𫛤	鴐
𫛥	鵊
𫛦	鴮
𫛧	𪀖
𫛨	鵧
𫛩	鴳
𫛪	鴽
𫛫	鶰
𫛬	䳜
𫛭	鵟
𫛮	䳤
𫛯	鶭
𫛰	䳢
𫛱	鵫
𫛲	鵰
𫛳	鵩
𫛴	鷤
𫛵	鶌
𫛶	鶒
𫛷	鶦
𫛸	鶗
𫛹	𪃧
𫛺	䳧
𫛻	𪃒
𫛼	䳫
𫛽	鷅
𫛾	𪆷
𫜀	鷐
𫜁	鷩
𫜂	𪅂
𫜃	鷣
𫜄	鷷
𫜅	䴋
𫜊	𪉸
𫜑	麷
𫜒	䴱
𫜓	𪌭
𫜔	䴽
𫜕	𪍠
𫜙	䵴
𫜟	𪓰
𫜨	䶕
𫜩	齧
𫜪	齩
𫜫	𫜦
𫜬	齰
𫜭	齭
𫜮	齴
𫜯	𪙏
𫜰	齾
𫜲	龓
𫜳	䶲
𫝈	㑮
𫝋	𠐊
𫝦	㛝
𫝧	㜐
𫝨	媈
𫝩	嬦
𫝪	𡟫
𫝫	婡
𫝬	嬇
𫝭	孆
𫝮	孄
𫝵	嶹
𫞅	𦠅
𫞗	潣
𫞚	澬
𫞛	㶆
𫞝	灍
𫞠	爧
𫞡	爃
𫞢	𤛱
𫞣	㹽
𫞥	珼
𫞦	璾
𫞧	𤩂
𫞨	璼
𫞩	璊
𫞷	𥢶
𫟃	絍
𫟄	綋
𫟅	綡
𫟆	緟
𫟇	𦆲
𫟑	䖅
𫟕	䕤
𫟞	訨
𫟟	詊
𫟠	譂
𫟡	誴
𫟢	䜖
𫟤	䡐
𫟥	䡩
𫟦	䡵
𫟫	𨞺
𫟬	𨟊
𫟲	釚
𫟳	釲
𫟴	鈖
𫟵	鈗
𫟶	銏
𫟷	鉝
𫟸	鉽
𫟹	鉷
𫟺	䤤
𫟻	銂
𫟼	鐽
𫟽	𨧰
𫟾	𨩰
𫟿	鎈
𫠀	䥄
𫠁	鑉
𫠂	閝
𫠅	韚
𫠆	頍
𫠇	𩖰
𫠈	䫾
𫠊	䮄
𫠋	騼
𫠌	𩦠
𫠏	𩵦
𫠐	魽
𫠑	䱸
𫠒	鱆
𫠖	𩿅
𫠜	齯
𫢸	僤
𫮃	墠
𫰛	娙
𫶇	嵽
𫷷	廞
𫸩	彄
𬀩	暐
𬬭	錀
𬬻	鑪
𬭊	𨧀
𬭛	𨨏
𬭳	𨭎
𬭶	𨭆
𬶋	鮈
𬶍	鮀
𬶏	鮠
𬶟	鯻
𬸪	鷭
阿斗	阿斗
阿杰	阿杰
阿卡提里	阿卡提里
阿拉	阿拉
阿拉干山脉	阿拉乾山脈
阿拉普利	阿拉普利
阿拉瑟希斯	阿拉瑟希斯
阿莱克希斯	阿萊克希斯
阿里	阿里
阿里斯托芬	阿里斯托芬
阿娘	阿孃
阿森松岛	阿森松島
阿斯马拉	阿斯馬拉
阿松森岛	阿松森島
阿托	阿託
阿托品	阿托品
阿咸	阿咸
阿扎	阿扎
阿扎尔	阿扎爾
阿扎伦卡	阿紮倫卡
阿芝特克人	阿芝特剋人
阿芝特克语	阿芝特剋語
哀吊	哀弔
哀戚	哀慼
哀挽	哀輓
埃迪蒙托	埃迪蒙託
埃夫伯里	埃夫伯里
埃格尔松	埃格爾松
埃及	埃及
埃及历	埃及曆
埃克托	埃克托
埃拉托塞尼斯	埃拉托塞尼斯
挨打	捱打
挨到	捱到
挨得	捱得
挨饿	捱餓
挨过	捱過
挨饥抵饿	捱飢抵餓
挨苦	捱苦
挨了	捱了
挨骂	捱罵
挨满	捱滿
挨磨	捱磨
挨日子	捱日子
挨三顶四	捱三頂四
挨上	捱上
挨时间	捱時間
挨整	捱整
挨揍	捱揍
矮杆品种	矮桿品種
矮几	矮几
艾达伊斯	艾達伊斯
艾回	艾迴
艾里赛宫	艾里賽宮
艾里森	艾里森
艾瑞里	艾瑞里
艾索雷葛斯	艾索雷葛斯
爱彼表	愛彼錶
爱困	愛睏
爱丽	愛麗
爱丽舍	愛麗舍
爱丽舍宫	愛麗捨宮
爱欲	愛慾
碍难	礙難
碍难照准	礙難照准
安多葛斯	安多葛斯
安纳托利亚	安納托利亞
安能日月共回光	安能日月共回光
安沈铁路	安瀋鐵路
安阳三熏	安陽三薰
安远县	安遠縣
庵蔼	菴藹
庵庵	菴菴
庵婪	菴婪
庵庐	菴廬
庵罗树园	菴羅樹園
庵舍	菴舍
案几	案几
案准	案准
暗吃一惊	暗吃一驚
暗火	闇火
暗扣	暗釦
暗蓝发	闇藍髮
暗劣	闇劣
暗乱	闇亂
暗伦	闇倫
暗昧	闇昧
暗冥	闇冥
暗莫	闇莫
暗浅	闇淺
暗然	闇然
暗弱	闇弱
暗诵	闇誦
暗叹	暗歎
暗跳	闇跳
盎盂相系	盎盂相繫
敖荡	敖盪
熬姜呷醋	熬薑呷醋
熬制	熬製
鼇头独占	鼇頭獨占
傲游志	傲遊志
奥里里亚	奧里里亞
奥里萨	奧里薩
奥斯伯	奧斯伯
奥特	奧特
奥特朗	奧特朗
奥特朗托	奧特朗托
奥托	奧托
澳普利	澳普利
八斗	八斗
八蜡	八蜡
八里	八里
八辟	八辟
八扎	八紮
八只	八隻
八周	八週
八字	八字
八字胡	八字鬍
巴斗	巴斗
巴拉松	巴拉松
巴厘岛	巴厘島
巴里	巴里
巴利扎尔	巴利扎爾
巴纳扎尔	巴納扎爾
巴松	巴鬆
巴松管	巴松管
巴托丽	巴托麗
巴托莉	巴托莉
巴游	巴游
芭托莉	芭托莉
笆斗	笆斗
拔发	拔髮
拔须	拔鬚
拔宅上升	拔宅上昇
把饭叫饥	把飯叫饑
吧台	吧檯
吧托女	吧托女
白发	白髮
白发银须	白髮銀鬚
白粉	白粉
白粉面	白粉麪
白杆兵	白桿兵
白干	白乾
白骨	白骨
白骨松	白骨松
白果	白果
白果松	白果松
白胡	白鬍
白里安	白里安
白面	白麪
白面无须	白面無鬚
白皮	白皮
白皮松	白皮松
白千层	白千層
白日难回光	白日難回光
白术	白朮
白松	白松
白须	白鬚
白羽插腰间	白羽插腰間
白玉换斗粟	白玉換鬥粟
白云	白雲
白云岩	白雲岩
百不当一	百不當一
百谷	百穀
百花	百花
百花历	百花曆
百里	百里
百炼	百鍊
百辟	百辟
百叶	百葉
百叶卷	百葉捲
百扎	百紮
百折千回	百折千回
百只	百隻
柏节松操	柏節松操
摆布	擺佈
摆荡	擺盪
摆钟	擺鐘
拜斗	拜斗
拜复	拜覆
拜里弗	拜裏弗
拜岳	拜岳
拜占庭	拜占庭
班衣戏彩	班衣戲彩
颁布	頒佈
斑岩	斑岩
斑衣戏彩	斑衣戲彩
板板	闆闆
板栗	板栗
板岩	板岩
办公	辦公
办公台	辦公檯
办伙	辦伙
办理一	辦理一
半干	半乾
半里	半里
半托	半托
半只	半隻
拌面	拌麪
绑扎	綁紮
棒子	棒子
棒子面	棒子麪
包干	包乾
包谷	包穀
包伙	包伙
包扎	包紮
包占	包占
褒采一介	褒采一介
褒赞	褒讚
薄幸	薄倖
宝丰	寶丰
宝里宝气	寶里寶氣
宝历	寶曆
宝志	寶誌
保险	保險
保险杆	保險桿
抱大足杆	抱大足桿
抱火卧薪	抱火臥薪
抱朴	抱朴
杯布	杯佈
杯干	杯乾
杯面	杯麪
杯赛	盃賽
悲戚	悲慼
悲筑	悲筑
碑志	碑誌
北斗	北斗
北回	北迴
北里	北里
北征	北征
贝尔	貝爾
贝尔托內	貝爾托內
贝里	貝里
贝那芬托	貝那芬托
贝那普利	貝那普利
贝胄	貝冑
备御	備禦
备注	備註
背榜	揹榜
背包	揹包
背出	背出
背出去	揹出去
背带	揹帶
背负	揹負
背回	揹回
背饥荒	揹饑荒
背筐	揹筐
背來	揹來
背篓	揹簍
背你	揹你
背人	揹人
背酸	背痠
背他	揹他
背她	揹她
背我	揹我
背物	揹物
背小孩	揹小孩
背债	揹債
背着	揹着
背走	揹走
被发	被髮
被复	被複
被人背	被人揹
被头	被頭
被头散发	被頭散髮
焙干	焙乾
呗赞	唄讚
本里	本里
本周	本週
畚斗	畚斗
逼并	逼併
鼻梁	鼻樑
鼻烟	鼻菸
比杆赛	比桿賽
比干	比干
彼得	彼得
彼得里皿	彼得里皿
秕谷	秕穀
笔杆	筆桿
笔管	筆管
笔管面	筆管麪
笔卷	筆捲
笔秃墨干	筆禿墨乾
毕升	畢昇
庇里牛斯	庇里牛斯
庇荫	庇廕
铋卷线	鉍卷線
碧眼紫须	碧眼紫鬚
弊幸	弊倖
壁志	壁誌
壁钟	壁鐘
避凶就吉	避凶就吉
避凶趋吉	避凶趨吉
嬖幸	嬖倖
臂一卷	臂一捲
砭针	砭鍼
编发	編髮
编余	編余
编钟	編鐘
鞭辟近里	鞭辟近裏
鞭辟入里	鞭辟入裏
扁拟谷盗虫	扁擬穀盜蟲
变速	變速
变速杆	變速桿
变质	變質
变质岩	變質岩
便吃干	便吃乾
便辟	便辟
遍布	遍佈
辨奸论	辨姦論
辫发	辮髮
标占	標占
标志	標誌
标致	標緻
标注	標註
标准	標準
标准杆	標準桿
表板	錶板
表厂	錶廠
表带	錶帶
表的	表的
表的嘀嗒	錶的嘀嗒
表的历史	錶的歷史
表店	錶店
表冠	錶冠
表行	錶行
表壳	錶殼
表快	錶快
表款	錶款
表链	錶鏈
表慢	錶慢
表蒙子	錶蒙子
表盘	錶盤
表速	錶速
表停	錶停
表王	錶王
表邪被湿持于里	表邪被溼持於裏
表演	表演
表演欲	表演慾
表针	錶針
表转	錶轉
别别扭扭	彆彆扭扭
别口气	彆口氣
别扭	彆扭
别拗	彆拗
别气	彆氣
别强	彆強
别日南鸿才北去	別日南鴻纔北去
别墅小长干	別墅小長幹
别着	彆着
别只	別隻
别致	別緻
别嘴	彆嘴
玢岩	玢岩
滨松	濱鬆
滨松市	濱松市
鬓发	鬢髮
冰斗	冰斗
冰碛	冰磧
冰碛岩	冰磧岩
冰岩	冰岩
饼干	餅乾
禀复	稟覆
并案	併案
并包	幷包
并不	並不
并不并	併不併
并产	併產
并成	併成
并除	併除
并到	併到
并叠	併疊
并发	併發
并购	併購
并骨	併骨
并合	併合
并火	併火
并肩	並肩
并肩子	併肩子
并兼	併兼
并卷机	併捲機
并科	併科
并力	併力
并拢	併攏
并名	併名
并入	併入
并纱	併紗
并吞	併吞
并网	併網
并为	併爲
并线	併線
并一不二	併一不二
并赃拿贼	併贓拿賊
并赃治罪	併贓治罪
并州	幷州
病愈	病癒
拨谷	撥穀
拨弦	撥絃
波荡	波盪
波尔干	波爾干
波发藻	波髮藻
波里	波里
剥制	剝製
菠萝	菠蘿
菠萝干	菠蘿乾
伯里克利	伯里克利
伯娘	伯孃
伯余	伯余
泊松	泊松
泊松分布	泊松分佈
博汇	博彙
簸荡	簸盪
卜征	卜征
逋发	逋髮
补扣	補釦
补注	補註
捕风系影	捕風繫影
捕虏岩	捕虜岩
捕影系风	捕影繫風
哺喂	哺餵
不并	不併
不惮	不憚
不惮强御	不憚強禦
不吊	不弔
不负所托	不負所托
不干	不幹
不干不净	不乾不淨
不干不淨吃了没病	不乾不淨吃了沒病
不干己事	不干己事
不干胶	不乾膠
不干你	不干你
不干他	不干他
不干它	不干它
不干她	不干她
不干我	不干我
不谷	不穀
不好	不好
不好干預	不好干預
不能捐斗粟	不能捐鬥粟
不气干	不氣干
不舍	不捨
不声不气	不聲不氣
不食干腊	不食乾腊
不讨采	不討采
不通吊庆	不通弔慶
不畏	不畏
不畏强御	不畏強禦
不系	不繫
不赞	不讚
不占	不佔
不占吉凶	不占吉凶
不占算	不占算
不占凶吉	不占凶吉
不准	不準
不准翻印	不准翻印
不准没	不准沒
不准你	不准你
不准谁	不准誰
不准他	不准他
不准它	不准它
不准她	不准她
不准问	不准問
不准我	不准我
布摆	佈擺
布班尼斯瓦	布班尼斯瓦
布菜	佈菜
布慈	佈慈
布道	佈道
布德	佈德
布防	佈防
布复	布覆
布干维尔	布干維爾
布岗	佈崗
布告	佈告
布谷	布穀
布谷鸟钟	布穀鳥鐘
布划	佈劃
布会	佈會
布教	佈教
布景	佈景
布局	佈局
布扣	佈扣
布莱克波尔	布萊克波爾
布雷	佈雷
布里	布里
布里斯托	布里斯托
布列	佈列
布鲁	布魯
布鲁托	布魯托
布伦	布倫
布伦托海	布倫托海
布满	佈滿
布囊	布囊
布囊其口	佈囊其口
布让	佈讓
布散	佈散
布哨	佈哨
布设	佈設
布施	佈施
布势	佈勢
布署	佈署
布托	布托
布网	佈網
布下	佈下
布线	佈線
布雪	佈雪
布一个	佈一個
布疑阵	佈疑陣
布于	佈於
布阵	佈陣
布政	佈政
布置	佈置
步步高升	步步高昇
步斗踏罡	步斗踏罡
步罡踏斗	步罡踏斗
擦干	擦乾
猜三划五	猜三划五
才不	纔不
才出	纔出
才此	纔此
才打	纔打
才当曹斗	才當曹斗
才到	纔到
才得到	纔得到
才得两年	纔得兩年
才等	纔等
才读	纔讀
才对	纔對
才多	纔多
才敢	纔敢
才干	才幹
才干杯	纔乾杯
才干旱	纔乾旱
才干淨	纔乾淨
才干透	纔乾透
才刚	纔剛
才给	纔給
才跟	纔跟
才够	纔夠
才怪	纔怪
才过来	纔過來
才过去	纔過去
才行	纔行
才好	纔好
才回	纔回
才会	纔會
才将	纔將
才讲	纔講
才开	纔開
才看	纔看
才可	纔可
才来	纔來
才料	纔料
才买	纔買
才没	纔沒
才拿	纔拿
才能	才能
才能夠	纔能夠
才能勇敢追	纔能勇敢追
才能有	纔能有
才派	纔派
才起来	纔起來
才去	纔去
才上到	纔上到
才上来	纔上來
才上去	纔上去
才始	纔始
才是	纔是
才松下	纔鬆下
才算	纔算
才爲	纔爲
才下来	纔下來
才下去	纔下去
才想	纔想
才像	纔像
才信	纔信
才要	纔要
才用	才用
才用到	纔用到
才有	纔有
才再	纔再
才在	纔在
才则	纔則
裁并	裁併
裁制	裁製
采采	采采
采椽不斲	采椽不斲
采地	采地
采蘩	采蘩
采风	採風
采风录	采風錄
采葛	采葛
采光	採光
采光剖璞	采光剖璞
采缉	采緝
采及葑菲	采及葑菲
采兰兼衣锦	採蘭兼衣錦
采兰赠芍	采蘭贈芍
采烈	采烈
采苓	采苓
采绿	采綠
采女	采女
采芑	采芑
采芹	采芹
采色	采色
采声	采聲
采诗	采詩
采石	採石
采石之役	采石之役
采石之战	采石之戰
采石之戰	采石之戰
采菽	采菽
采头	采頭
采薇	采薇
采薪	採薪
采薪之疾	采薪之疾
采薪之忧	采薪之憂
采衣	采衣
采邑	采邑
采制	採製
彩笔	彩筆
彩笔生	彩筆生
彩笔生花	綵筆生花
彩绸	綵綢
彩船	綵船
彩带	綵帶
彩缎	綵緞
彩凤	綵鳳
彩蛤攒锦囊	彩蛤攢錦囊
彩楼	綵樓
彩鸾	綵鸞
彩女	綵女
彩牌楼	綵牌樓
彩棚	綵棚
彩球	綵球
彩胜	綵勝
彩线	綵線
彩衣	綵衣
彩缯	綵繒
菜干	菜乾
菜苔	菜薹
蔡松坡	蔡松坡
参横斗转	參橫鬥轉
参回斗转	參回鬥轉
参茸	蔘茸
参绥	蔘綏
参汤	蔘湯
餐松啖柏	餐松啖柏
餐松食柏	餐松食柏
餐松饮涧	餐松飲澗
餐台	餐檯
残雪乱山中	殘雪亂山中
蚕头凤尾	蠶頭鳳尾
惨戚	慘慼
苍发	蒼髮
苍术	蒼朮
苍松	蒼松
沧浪渡头柳花发	滄浪渡頭柳花發
沧溟在一毫	滄溟在一毫
藏历	藏曆
藏蒙歌儿	藏矇歌兒
操纵	操縱
操纵杆	操縱桿
操纵台	操縱檯
操作	操作
操作台	操作檯
操作钟	操作鐘
曹郁芬	曹郁芬
漕挽	漕輓
艸木丰丰	艸木丰丰
草庵	草菴
草荐	草荐
草签	草簽
草思晴后发	草思晴後發
草席	草蓆
测利得	測利得
测量	測量
测量杆	測量桿
涔阳女儿花满头	涔陽女兒花滿頭
杈杆儿	杈桿兒
茶几	茶几
茶面	茶麪
茶托	茶托
茶已干	茶已乾
查核	查覈
査报表	查報表
査表	查表
査不出	查不出
査出	查出
査兑克	查兌克
査号台	查號臺
査回	查回
査获	查獲
査价	查價
査卷	查卷
査克拉	查克拉
査问出	查問出
査无实据	查無實據
査修	查修
査询台	查詢檯
査找周期	查找週期
搽穰卷儿	搽穰捲兒
察核	察覈
柴门空闭锁松筠	柴門空閉鎖鬆筠
产后	產後
产后检査	產後檢查
产制	產製
铲板	剷板
铲草	剷草
铲铲	剷剷
铲车	剷車
铲出	剷出
铲除	剷除
铲刀	剷刀
铲倒	剷倒
铲掉	剷掉
铲斗	剷鬥
铲断	剷斷
铲煤	剷煤
铲平	剷平
铲起	剷起
铲抢	剷搶
铲球	剷球
铲伤	剷傷
铲射	剷射
铲土	剷土
铲下	剷下
铲雪	剷雪
铲刈	剷刈
铲凿	剷鑿
肠系膜	腸繫膜
肠脏	腸臟
尝遍	嚐遍
尝尝	嚐嚐
尝出	嚐出
尝胆卧薪	嘗膽臥薪
尝到	嚐到
尝点	嚐點
尝个	嚐個
尝尽	嚐盡
尝来尝去	嚐來嚐去
尝了	嚐了
尝了尝	嚐了嚐
尝起来	嚐起來
尝鲜	嚐鮮
厂部	厂部
唱念	唱唸
超基性岩	超基性岩
超级	超級
超级杯	超級盃
超赞	超讚
朝骑五花马	朝騎五花馬
朝钟	朝鐘
潮回远复平	潮回遠復平
潮烟	潮菸
炒面	炒麪
车斗	車斗
车夫	車伕
车里	車裏
车里雅宾斯克	車里雅賓斯克
车仔面	車仔麪
扯面	扯麪
扯纤	扯縴
撤并	撤併
尘陌望松雪	塵陌望鬆雪
沉积	沉積
沉积金	沉積金
沉积岩	沉積岩
陈冲	陳沖
陈干村	陳幹村
陈汉升	陳漢昇
陈杰	陳杰
陈炼	陳鍊
陈升	陳昇
陈世杰	陳世杰
陈万松	陳萬松
陈幸	陳幸
陈幸嫚	陳倖嫚
陈尹杰	陳尹杰
陈瀛钟	陳瀛鐘
陈郁秀	陳郁秀
晨钟	晨鐘
衬托	襯托
称叹	稱歎
称赞	稱讚
蛏干	蟶乾
成岩	成巖
成岩作用	成岩作用
呈准	呈准
承制	承製
乘凶完配	乘凶完配
秤杆	秤桿
秤平斗满	秤平斗滿
吃板刀面	吃板刀麪
吃饱了饭撑的	吃飽了飯撐的
吃饱没事干	吃飽沒事幹
吃不出	吃不出
吃不了	吃不了
吃出	吃出
吃错药	吃錯藥
吃得出	吃得出
吃得了	吃得了
吃地面	吃地面
吃钉板	吃釘板
吃豆干	吃豆乾
吃饭	喫飯
吃饭别忘了种谷人	吃飯別忘了種穀人
吃饭家伙	吃飯家伙
吃饭傢伙	吃飯傢伙
吃干醋	吃乾醋
吃干了	吃乾了
吃挂络儿	吃掛絡兒
吃过面	吃過麪
吃合家欢	吃合家歡
吃后悔药	吃後悔藥
吃回头草	吃回頭草
吃几碗干饭	吃幾碗乾飯
吃姜	吃薑
吃尽	吃盡
吃亏	喫虧
吃亏就是占便宜	吃虧就是佔便宜
吃亏上当	吃虧上當
吃辣面	吃辣麪
吃了	吃了
吃里扒外	吃裏扒外
吃里爬外	吃裏爬外
吃面	吃麪
吃枪药	吃槍藥
吃敲才	吃敲才
吃人虫	吃人蟲
吃人一个蛋恩情无法断	吃人一個蛋恩情無法斷
吃伤了	吃傷了
吃完面	吃完麪
吃闲饭	吃閒飯
吃闲话	吃閒話
吃烟	吃煙
吃药	吃藥
吃一顿挨一顿	吃一頓挨一頓
喫亏的是乖占便宜的是呆	喫虧的是乖占便宜的是呆
池内设置斜管	池內設置斜管
迟回	遲迴
持男易斗粟	持男易鬥粟
尺布斗粟	尺布斗粟
尺寸	尺寸
尺寸斗粟	尺寸斗粟
齿发	齒髮
齿危发秀	齒危髮秀
斥卤	斥鹵
赤绳系足	赤繩繫足
赤术	赤朮
赤松	赤松
冲鼻	沖鼻
冲厕所	沖廁所
冲茶	沖茶
冲冲	沖沖
冲牀工	沖牀工
冲淡	沖淡
冲涤	沖滌
冲掉	沖掉
冲断	沖斷
冲服	沖服
冲沟	沖溝
冲冠	衝冠
冲冠发怒	衝冠髮怒
冲冠怒发	衝冠怒發
冲和	沖和
冲怀	沖懷
冲坏	沖壞
冲毁	沖毀
冲积	沖積
冲剂	沖劑
冲襟	沖襟
冲决	沖決
冲克	沖剋
冲空	衝空
冲空机	沖空機
冲垮	沖垮
冲扩	沖擴
冲凉	沖涼
冲淋	衝淋
冲淋浴	沖淋浴
冲龄	沖齡
冲流	沖流
冲昧	沖昧
冲模	沖模
冲末	沖末
冲默	沖默
冲年	沖年
冲泡	沖泡
冲人	沖人
冲弱	沖弱
冲绳	沖繩
冲蚀	沖蝕
冲刷	沖刷
冲水	沖水
冲税	沖稅
冲塌	沖塌
冲天	沖天
冲田	沖田
冲洗	沖洗
冲喜	沖喜
冲销	沖銷
冲霄	沖霄
冲泻	沖瀉
冲虚	沖虛
冲印	沖印
冲澡	沖澡
冲帐	沖帳
冲州撞府	衝州撞府
冲走	沖走
充气公仔	充氣公仔
舂谷	舂穀
虫部	虫部
虫吃牙	蟲吃牙
抽斗	抽斗
抽干	抽乾
抽烟	抽菸
仇仇	仇讎
惆怅梅花发	惆悵梅花發
丑旦	丑旦
丑角	丑角
丑年	丑年
丑牛	丑牛
丑奴儿	醜奴兒
丑日	丑日
丑三	丑三
丑时	丑時
丑月	丑月
偢采	偢采
瞅下表	瞅下錶
瞅下钟	瞅下鐘
臭局	臭侷
臭熏熏	臭燻燻
出陈布新	出陳佈新
出丑	出醜
出丑狼借	出醜狼藉
出儿	齣兒
出关策匹马	出關策匹馬
出家	出家
出家人	出家人
出家人吃八方	出家人吃八方
出戏	齣戲
出汙泥而不染	出污泥而不染
出征	出征
初征	初征
除旧布新	除舊佈新
触须	觸鬚
搋面	搋麪
川谷	川穀
川后	川后
川原无不通	川原無不通
传布	傳佈
传位于四太子	傳位于四太子
船夫	船伕
船娘	船孃
船只	船隻
船钟	船鐘
遄征	遄征
串游	串游
窗明几净	窗明几淨
窗明几亮	窗明几亮
窗外齐垂旭日初	窗外齊垂旭日初
床席	牀蓆
闯炼	闖鍊
创获	創穫
创巨	創鉅
创意	創意
创意杯	創意盃
吹发	吹髮
吹干	吹乾
吹胡	吹鬍
炊臼之戚	炊臼之鏚
炊烟	炊煙
炊烟袅袅	炊煙裊裊
垂发	垂髮
捶炼	捶鍊
捶台拍凳	捶檯拍凳
锤炼	錘鍊
春城见松雪	春城見鬆雪
春卷	春捲
春笋怒发	春筍怒發
春武里府	春武里府
春夏里	春夏裏
唇干	脣乾
唇焦口燥	脣焦口燥
唇燥舌干	脣燥舌乾
脣若抹朱	脣若抹硃
脣若涂朱	脣若塗硃
脣似抹朱	脣似抹硃
淳和睹太初	淳和睹太初
淳于	淳于
醇郁	醇郁
词采	詞采
词汇	詞彙
辞采	辭采
辞汇	辭彙
慈悲	慈悲
慈悲喜舍	慈悲喜捨
磁制	磁製
此不可干	此不可幹
此路不通	此路不通
此仆彼起	此仆彼起
此系	此係
刺参	刺蔘
刺干	刺干
赐恤	賜卹
苁蓉羊肉羹	蓯蓉羊肉羹
葱葱	蔥蔥
葱葱郁郁	蔥蔥郁郁
葱姜	蔥姜
葱姜蒜	蔥薑蒜
粗管	粗管
粗管面	粗管麪
粗卤	粗鹵
粗面	粗麪
粗面岩	粗面岩
粗制	粗製
醋栗	醋栗
醋坛	醋罈
催并	催併
脆谷乐	脆穀樂
淬炼	淬鍊
存托股	存托股
存亡不重见	存亡不重見
存折	存摺
寸发千金	寸髮千金
错彩镂金	錯彩鏤金
搭干铺	搭乾鋪
达欣	達欣
达欣杯	達欣盃
答复	答覆
打挨	打捱
打并	打併
打出	打出
打出吊入	打出弔入
打谷	打穀
打哄	打鬨
打簧表	打簧錶
打桨杆	打槳桿
打卡	打卡
打卡钟	打卡鐘
打游飞	打游飛
打游击	打游擊
打制	打製
打中	打中
打中伙	打中伙
打钟	打鐘
大本钟	大本鐘
大笨钟	大笨鐘
大便不通	大便不通
大病	大病
大病初愈	大病初癒
大不里士	大不里士
大采	大采
大冲	大沖
大虫	大蟲
大虫不吃伏肉	大蟲不吃伏肉
大虫吃小虫	大蟲吃小蟲
大丑	大丑
大斗	大斗
大夫	大夫
大夫松	大夫松
大吉大利	大吉大利
大鉴	大鑒
大金发苔	大金髮薹
大扣欲干云	大扣欲幹雲
大蜡	大蜡
大里	大里
大理	大理
大理岩	大理岩
大历	大曆
大利面	大利麪
大麻	大麻
大麻里	大麻里
大面白	大面白
大明	大明
大明历	大明曆
大目干连	大目乾連
大辟	大辟
大曲	大麴
大水	大水
大水冲倒龙王殿	大水沖倒龍王殿
大水冲倒龙王庙	大水沖倒龍王廟
大水冲溺	大水沖溺
大武仑	大武崙
大咸	大咸
大型	大型
大型钟	大型鐘
大凶	大凶
大言非夸	大言非夸
大衍历	大衍曆
大一统	大一統
大一统志	大一統誌
大赞	大讚
大折儿	大摺兒
大只	大隻
大钟	大鐘
大周后	大周后
大专	大專
大专杯	大專盃
呆致致	呆緻緻
逮系	逮繫
代签	代簽
带发修行	帶髮修行
带凶	帶凶
待核	待覈
袋表	袋錶
戴表	戴錶
戴发含齿	戴髮含齒
戴眉含齿	戴眉含齒
戴维斯	戴維斯
戴维斯杯	戴維斯盃
丹参	丹蔘
丹干	丹干
丹橘黄甘此地无	丹橘黃甘此地無
担担面	擔擔麪
担干纪	擔干紀
担仔面	擔仔麪
单夫只妇	單夫隻婦
单排档	單排檔
单枪匹马	單槍匹馬
单位	單位
单位信托	單位信托
单弦	單絃
单于	單于
单只	單隻
单周	單週
胆大	膽大
胆大如斗	膽大如斗
胆大于天	膽大於天
但得一片橘皮吃且莫忘了洞庭湖	但得一片橘皮吃且莫忘了洞庭湖
但云	但云
弹丝托	彈絲託
弹弦奏节梅风入	彈弦奏節梅風入
弹珠台	彈珠檯
弹子	彈子
弹子台	彈子檯
澹荡	澹盪
当当	噹噹
当当当	噹噹噹
当的一声	噹的一聲
当的一响	噹的一響
当家	當家
当家才知柴米价	當家纔知柴米價
当啷	噹啷
当时四十万匹马	當時四十萬匹馬
当一声	噹一聲
当周	當週
挡御	擋禦
党参	黨蔘
党怀英	党懷英
党进	党進
党太尉	党太尉
党太尉吃匾食	党太尉吃匾食
党项	党項
党項	党項
党支书	党支書
荡出	盪出
荡船	盪船
荡荡	蕩蕩
荡荡悠悠	盪盪悠悠
荡到	盪到
荡涤	盪滌
荡风	盪風
荡复	蕩覆
荡垢涤汙	盪垢滌污
荡寒	盪寒
荡检逾闲	蕩檢逾閑
荡酒	盪酒
荡开	盪開
荡口	盪口
荡来荡去	盪來盪去
荡气回阳	蕩氣迴陽
荡秋千	盪鞦韆
荡瑕涤秽	蕩瑕滌穢
荡漾	盪漾
荡悠悠	盪悠悠
荡舟	盪舟
叨念	叨唸
捣鬼	搗鬼
捣鬼吊白	搗鬼弔白
倒八字须	倒八字鬚
倒二叶	倒二葉
倒念	倒唸
倒悬	倒懸
倒悬挨命	倒懸捱命
祷念	禱唸
盗钟	盜鐘
道里	道里
稻谷	稻穀
得采	得采
德干	德干
德高而毁来	德高而譭來
德里	德里
德利得	德利得
德胜	德勝
德胜头回	德勝頭迴
的钟	的鐘
灯彩	燈綵
等压面	等壓面
低荡	低盪
低回	低迴
嘀嗒	嘀嗒
嘀嗒的表	嘀嗒的錶
滴干	滴乾
滴里耷拉	滴里耷拉
滴里搭拉	滴里搭拉
滴里嘟噜	滴里嘟嚕
狄志杰	狄志杰
敌抗一号	敵抗一號
涤荡	滌盪
涤秽荡瑕	滌穢盪瑕
涤瑕荡垢	滌瑕盪垢
涤瑕荡秽	滌瑕盪穢
诋毁	詆譭
抵触	牴觸
抵牾	牴牾
抵御	抵禦
地多齐后	地多齊後
地复天翻	地覆天翻
地覆天翻	地覆天翻
地拉普利	地拉普利
地塞米松	地塞米松
地三叶	地三葉
地湿烟尝起	地溼煙嘗起
地无三里平	地無三里平
地一卷	地一捲
地志	地誌
帝后	帝后
帝力收三统	帝力收三統
递回	遞迴
第八出	第八齣
第二出	第二齣
第九出	第九齣
第六出	第六齣
第七出	第七齣
第三出	第三齣
第十出	第十齣
第四出	第四齣
第五出	第五齣
第一	第一
第一出	第一齣
颠颠仆仆	顛顛仆仆
颠复	顛覆
颠仆	顛仆
攧攧仆仆	攧攧仆仆
点半钟	點半鐘
点多钟	點多鐘
点烟	點菸
点钟	點鐘
电表	電錶
电复	電覆
电胡刀	電鬍刀
电脑	電腦
电脑台	電腦檯
电砂锅	電砂鍋
电须刀	電鬚刀
电钟	電鐘
电子	電子
电子表	電子錶
电子钟	電子鐘
殿钟自鸣	殿鐘自鳴
刁斗	刁斗
刁奸	刁姦
貂复额	貂覆額
雕鹗	鵰鶚
雕悍	鵰悍
雕具	雕具
雕具座	鵰具座
雕梁	雕樑
雕翎	鵰翎
雕心雁爪	鵰心雁爪
吊词	弔詞
吊奠	弔奠
吊斗	吊斗
吊古	弔古
吊诡	弔詭
吊贺迎送	弔賀迎送
吊鹤	弔鶴
吊喉	弔喉
吊谎	弔謊
吊祭	弔祭
吊脚	吊腳
吊脚儿	吊腳兒
吊脚儿事	弔腳兒事
吊拷	弔拷
吊客	弔客
吊民	弔民
吊旗	弔旗
吊撒	弔撒
吊丧	弔喪
吊书	弔書
吊死	吊死
吊死问孤	弔死問孤
吊死问疾	弔死問疾
吊头	弔頭
吊慰	弔慰
吊文	弔文
吊问	弔問
吊孝	弔孝
吊唁	弔唁
吊宴	弔宴
吊喭	弔喭
吊腰撒跨	弔腰撒跨
吊影	弔影
吊者大悦	弔者大悅
吊纸	弔紙
吊钟	吊鐘
掉发	掉髮
爹娘	爹孃
叠层岩	疊層岩
蹀里蹀斜	蹀里蹀斜
丁丑	丁丑
丁固生松	丁固生松
叮当	叮噹
顶针	頂針
顶针挨住	頂針捱住
订制	訂製
钉扣	釘釦
定远县	定遠縣
定制	定製
东仓里	東倉里
东风动地只花发	東風動地只花發
东干	東干
东里	東里
东林精舍近	東林精舍近
东山	東山
东山里	東山里
东升	東昇
东征	東征
东芝	東芝
东芝医疗系	東芝醫療繫
东周	東周
东周钟	東周鐘
冬冬	鼕鼕
冬青尚满洲	冬青尚滿洲
董里府	董里府
董氏封发	董氏封髮
动荡	動盪
冻鸡腿	凍雞腿
栋梁	棟樑
都舍下	都捨下
斗柄	斗柄
斗车	斗車
斗城	斗城
斗储	斗儲
斗大	斗大
斗胆	斗膽
斗的	斗的
斗灯	斗燈
斗店	斗店
斗顿	斗頓
斗方	斗方
斗府	斗府
斗概	斗概
斗拱	斗拱
斗栱	斗栱
斗哄	鬥鬨
斗斛之禄	斗斛之祿
斗箕	斗箕
斗极	斗極
斗酒	斗酒
斗酒只鸡	斗酒隻雞
斗居	斗居
斗绝	斗絕
斗魁	斗魁
斗笠	斗笠
斗量	斗量
斗六	斗六
斗罗大陆	斗羅大陸
斗门	斗門
斗米尺布	鬥米尺布
斗南	斗南
斗牛	鬥牛
斗牛之间	斗牛之間
斗蓬装	斗蓬裝
斗篷	斗篷
斗渠	斗渠
斗然	斗然
斗山	斗山
斗筲	斗筲
斗杓	斗杓
斗升	斗升
斗食	斗食
斗室	斗室
斗数	斗數
斗薮	斗藪
斗粟尺布	斗粟尺布
斗粟囊金	斗粟囊金
斗尾港	斗尾港
斗纹	斗紋
斗香	斗香
斗小马	斗小馬
斗烟丝	斗菸絲
斗斋	斗齋
斗帐	斗帳
斗折蛇行	斗折蛇行
斗真	斗真
斗重山齐	斗重山齊
斗转参横	斗轉參橫
斗转星移	斗轉星移
斗子	斗子
豆干	豆乾
豆干肉丝	豆干肉絲
豆面	豆麪
豆签	豆簽
毒僵指	毒殭指
独卧秋窗明	獨臥秋窗明
独有南山桂花发	獨有南山桂花發
独占鼇头	獨佔鼇頭
读书	讀書
读书三余	讀書三余
赌台	賭檯
杜老志道	杜老誌道
杜隆塔尔虎皮	杜隆塔爾虎皮
杜雅里克	杜雅里克
短发	短髮
短几	短几
短须	短鬚
短衣匹马	短衣匹馬
断发	斷髮
断弦	斷絃
断纸余墨	斷紙余墨
锻炼	鍛鍊
堆案盈几	堆案盈几
对表	對錶
对凤连鸡一何小	對鳳連雞一何小
对折	對摺
对中环	對中環
对准	對準
对准表	對準錶
对准钟	對準鐘
多采	多采
多层复	多層複
多吃多占	多吃多佔
多个	多箇
多少	多少
多少只	多少隻
多凶少吉	多凶少吉
多只	多隻
夺杯	奪盃
俄制	俄製
额我略历	額我略曆
恶心	噁心
恶意	惡意
恶意毁谤	惡意譭謗
恶唑啉	噁唑啉
恩准	恩准
摁扣	摁釦
而云	而云
二苯恶唑	二苯惡唑
二苯基恶唑	二苯基惡唑
二斗	二斗
二恶英	二噁英
二缶钟惑	二缶鐘惑
二杆子	二桿子
二纪何曾离一日	二紀何曾離一日
二里	二里
二仑	二崙
二娘	二孃
二撇胡	二撇鬍
二手	二手
二手烟	二手菸
二弦	二絃
二叶松	二葉松
二只	二隻
二周	二週
发辫	髮辮
发表	發表
发表欲	發表慾
发鬓	髮鬢
发布	發佈
发采扬明	發采揚明
发菜	髮菜
发钗	髮釵
发带	髮帶
发雕	髮雕
发短心长	髮短心長
发匪	髮匪
发肤	髮膚
发复	發覆
发干	發乾
发根	髮根
发箍	髮箍
发冠卷尾	發冠卷尾
发光	發光
发光可鉴	髮光可鑑
发号	發號
发号布令	發號佈令
发际	髮際
发髻	髮髻
发夹	髮夾
发笺	髮箋
发胶	髮膠
发脚	髮腳
发结	髮結
发姐	髮姐
发禁	髮禁
发卷	髮捲
发卡	髮卡
发困	發睏
发腊	髮臘
发蜡	髮蠟
发廊	髮廊
发量	髮量
发乱钗横	髮亂釵橫
发蒙	發矇
发面	發麪
发漂	髮漂
发妻	髮妻
发圈	髮圈
发如飞蓬	髮如飛蓬
发乳	髮乳
发色	髮色
发纱	髮紗
发上	發上
发上冲冠	髮上衝冠
发上指冠	髮上指冠
发梢	髮梢
发式	髮式
发饰	髮飾
发梳	髮梳
发束	髮束
发霜	髮霜
发丝	髮絲
发套	髮套
发挽双髻	髮挽雙髻
发网	髮網
发为血之本	髮爲血之本
发尾	髮尾
发屋	髮屋
发香	髮香
发型	髮型
发须斑	髮鬚斑
发须都	髮鬚都
发须皆	髮鬚皆
发须俱	髮鬚俱
发须已	髮鬚已
发癣	髮癬
发已霜白	髮已霜白
发引	發引
发引千钧	髮引千鈞
发缨	髮纓
发踊冲冠	髮踊沖冠
发油	髮油
发簪	髮簪
发长	髮長
发针	髮針
发政施仁	發政施仁
发指	髮指
发质	髮質
发状	髮狀
廢后	廢后
法拉	法拉
法拉托	法拉托
法外施仁	法外施仁
翻复	翻覆
翻来复去	翻來覆去
翻手作云复手雨	翻手作雲覆手雨
翻台	翻檯
翻云复雨	翻雲覆雨
凡布利安纳	凡布利安納
烦复	煩複
繁复	繁複
繁钟	繁鐘
反铲	反剷
反斗	反斗
反反复复	反反覆覆
反复	反覆
反卷	反捲
反乱并	反亂併
返还	返還
返还占有	返還占有
返里	返里
返照回光	返照回光
饭后	飯後
饭后钟	飯後鐘
饭团	飯糰
泛滥	氾濫
泛水	泛水
泛水凌山	汎水淩山
范冰冰	范冰冰
范陈柏	范陳柏
范成大	范成大
范德格拉夫	范德格拉夫
范德林特	范德林特
范德萨	范德薩
范德瓦耳斯	范德瓦耳斯
范德维德	范德維德
范登堡	范登堡
范范之辈	范範之輩
范甘迪	范甘迪
范纲武	范綱武
范戈德	范戈德
范公偁	范公偁
范公堤	范公堤
范光群	范光羣
范国铨	范國銓
范哈能	范哈能
范皓阗	范皓闐
范洪森	范洪森
范家	範家
范家谦	范家謙
范嘉骅	范嘉驊
范姜	范姜
范进	范進
范靖瑶	范靖瑤
范雎	范雎
范可钦	范可欽
范宽	范寬
范蠡	范蠡
范伦铁诺	范倫鐵諾
范履霜	范履霜
范尼斯特鲁伊	范尼斯特魯伊
范佩西	范佩西
范琪斐	范琪斐
范绮馨	范綺馨
范士丹	范士丹
范斯	範斯
范斯坦	范斯坦
范特尔	范特爾
范特西	范特西
范玮琪	范瑋琪
范文	範文
范文程	范文程
范文芳	范文芳
范文虎	范文虎
范文澜	范文瀾
范文藤	范文藤
范文同	范文同
范文照	范文照
范文正公	范文正公
范湘暄	范湘暄
范小姐	范小姐
范晓萱	范曉萱
范筱梵	范筱梵
范欣妤	范欣妤
范阳	范陽
范晔	范曄
范逸臣	范逸臣
范增	范增
范张鸡黍	范張雞黍
范正祥	范正祥
范织钦	范織欽
范植谷	范植谷
范植伟	范植偉
范志毅	范志毅
范仲淹	范仲淹
方便	方便
方便面	方便麪
方才	方纔
方几	方几
方里	方里
方岳	方岳
方志	方誌
防台	防颱
防御	防禦
仿佛	彷彿
仿制	仿製
放蒙挣	放懞掙
放松	放鬆
放松管制	放松管制
飞刍挽粒	飛芻輓粒
飞刍挽粮	飛芻輓糧
飞刍挽粟	飛芻輓粟
飞行	飛行
飞行钟	飛行鐘
飞梁	飛樑
飞粮挽秣	飛糧輓秣
飞升	飛昇
飞书白帝营斗粟	飛書白帝營鬥粟
飞扎	飛紮
飞征	飛征
非签不可	非簽不可
非游离辐射伤害	非游離輻射傷害
菲普利	菲普利
菲舍尔	菲捨爾
肥皂	肥皂
肥皂莢	肥皂荚
肥皂劇	肥皂剧
肥皂絲	肥皂丝
肥筑方言	肥筑方言
肺脏	肺臟
废后	廢后
费尔	費爾
费尔干纳	費爾干納
费里克斯	費里克斯
分半钟	分半鐘
分布	分佈
分多钟	分多鐘
分钟	分鐘
分子	分子
分子钟	分子鐘
焚毁	焚燬
粉面	粉面
粉面朱脣	粉面硃脣
粪秽蔑面	糞穢衊面
丰标	丰標
丰采	丰采
丰城	豐城
丰城贯斗	豐城貫斗
丰度	丰度
丰情	丰情
丰茸	丰茸
丰容	丰容
丰若有肌柔若无骨	丰若有肌柔若無骨
丰神	丰神
丰溪	豐溪
丰溪里	豐溪里
丰仪	丰儀
丰儀	丰儀
丰韵	丰韻
丰韻	丰韻
丰姿	丰姿
风采	風采
风尘淹别日	風塵淹別日
风斗	風斗
风干	風乾
风刮	風颳
风后	風后
风卷	風捲
风入松	風入松
风土	風土
风土志	風土誌
风物	風物
风物志	風物誌
风烟彭泽里	風煙彭澤裏
封后	封后
封妻荫子	封妻廕子
封作天齐王	封作天齊王
風采	風采
峰回	峯迴
葑菲之采	葑菲之采
蜂后	蜂后
逢凶化吉	逢凶化吉
缝制	縫製
凤皇于蜚	鳳皇于蜚
凤凰	鳳凰
凤凰于蜚	鳳凰于蜚
凤台	鳳台
凤尾松	鳳尾松
凤占	鳳占
奉干	奉干
奉公	奉公
奉公克己	奉公剋己
佛里特	佛里特
佛历	佛曆
佛罗里达	佛羅里達
佛钟	佛鐘
夫力	伕力
夫役	伕役
肤发	膚髮
弗兰扎尔	弗蘭扎爾
弗里得里希	弗裏得裏希
弗里德里希	弗里德里希
弗里敦	弗里敦
弗里曼	弗里曼
伏几	伏几
扶幼周	扶幼週
扶余	扶余
拂荡	拂盪
拂须	拂鬚
拂钟无声	拂鐘無聲
服饰	服飾
服饰周	服飾週
服务	服務
服务台	服務檯
服装	服裝
服装周	服裝週
浮梁	浮樑
浮签	浮簽
浮托	浮托
浮游	浮游
浮云连海岳	浮雲連海嶽
符采	符采
福生于微	福生于微
福辛普利	福辛普利
福荫	福廕
抚尸	撫屍
抚尸恸哭	撫尸慟哭
抚松	撫松
抚恤	撫卹
抚远县	撫遠縣
腑脏	腑臟
腐干	腐乾
父母	父母
父母在不远游	父母在不遠游
父兄未许人	父兄未許人
负图之托	負圖之托
妇人	婦人
妇人生须	婦人生鬚
附膻逐臭	附膻逐臭
附膻逐秽	附膻逐穢
附膻逐腥	附膻逐腥
附注	附註
复按	覆按
复败	覆敗
复杯	覆杯
复被	覆被
复本	複本
复比	複比
复庇之恩	覆庇之恩
复蔽	覆蔽
复壁	複壁
复变函数	複變函數
复瓿	覆瓿
复测	複測
复查	複查
复査	複查
复车	覆車
复称	複稱
复成	覆成
复呈	覆呈
复帱	覆幬
复词	複詞
复次	複次
复道	複道
复电	覆電
复鼎	覆鼎
复对数	複對數
复发	復發
复发率	複發率
复发性	複發性
复方	複方
复肥	複肥
复分解	複分解
复分数	複分數
复分析	複分析
复辅音	複輔音
复复	複復
复盖	覆蓋
复阁	複閣
复共轭	複共軛
复果	複果
复海移山	覆海移山
复醢	覆醢
复函	覆函
复函数	複函數
复合	複合
复核	複覈
复婚	復婚
复婚制	複婚制
复基	復基
复基因	複基因
复检	複檢
复酱瓿	覆醬瓿
复蕉寻鹿	覆蕉尋鹿
复句	複句
复决	複決
复军	覆軍
复利	複利
复列	複列
复流	複流
复鹿寻蕉	覆鹿尋蕉
复鹿遗蕉	覆鹿遺蕉
复露	覆露
复冒	覆冒
复没	覆沒
复灭	覆滅
复名	複名
复命	覆命
复亩珍	複畝珍
复目	複目
复墓	覆墓
复逆	覆逆
复拍子	複拍子
复盘	覆盤
复盆	覆盆
复辟	復辟
复频	複頻
复品牌	複品牌
复平面	複平面
复评	複評
复钱	複錢
复去翻来	覆去翻來
复仞年如	複仞年如
复襦	複襦
复赛	複賽
复色	複色
复上	覆上
复审	複審
复式	複式
复试	複試
复视	複視
复述	複述
复数	複數
复水	覆水
复诵	複誦
复苏	復甦
复文	覆文
复习	複習
复线	複線
复相	復相
复相关	複相關
复校	覆校
复写	複寫
复信	覆信
复姓	複姓
复选	複選
复穴	複穴
复循环发电	複循環發電
复训	複訓
复盐	複鹽
复眼	複眼
复验	複驗
复叶	複葉
复以百万	複以百萬
复议	複議
复意	複意
复音	複音
复印	複印
复用	複用
复盂	覆盂
复雨翻云	覆雨翻雲
复育	覆育
复元	復元
复元音	複元音
复员	復員
复员军人	複員軍人
复阅	複閱
复韵	複韻
复杂	複雜
复载	覆載
复在	覆在
复帐	覆帳
复辙	覆轍
复诊	複診
复殖目	複殖目
复殖吸虫	複殖吸蟲
复制	複製
复种	複種
复舟	覆舟
复住	覆住
复子明辟	復子明辟
复字键	複字鍵
复宗	覆宗
复综语	複綜語
复𫗧	覆餗
副词片语	副詞片語
傅里叶	傅里葉
傅匀余	傅勻余
富里	富里
富民港第二	富民港第二
富新第二	富新第二
腹中无一物	腹中無一物
蝮蛇皮	蝮蛇皮
覆去翻来	覆去翻來
覆雨翻云	覆雨翻雲
馥郁	馥郁
该钟	該鐘
改念	改唸
改签	改簽
盖尔范德	蓋爾範德
肝脏	肝臟
竿头日进	竿頭日進
扞御	扞禦
杆秤	桿秤
杆刀	桿刀
杆菌	桿菌
杆茵	桿茵
杆直	桿直
杆状	桿狀
赶面棍	趕麪棍
赶制	趕製
敢斗了胆	敢斗了膽
敢引佩以指水	敢引佩以指水
橄榄	橄欖
橄榄岩	橄欖岩
擀面	擀麪
干阿奶	乾阿奶
干碍	干礙
干熬	乾熬
干巴	乾巴
干爸	乾爸
干白	乾白
干杯	乾杯
干贝	乾貝
干绷	乾繃
干逼	乾逼
干煸	乾煸
干扁	幹扁
干扁豆角	干扁豆角
干瘪	乾癟
干冰	乾冰
干剥剥	乾剝剝
干不	幹不
干不干杯	乾不乾杯
干不干净	乾不乾淨
干布	乾布
干擦	乾擦
干材	乾材
干菜	乾菜
干草	乾草
干茶钱	乾茶錢
干柴	乾柴
干产	乾產
干唱	乾唱
干炒牛河	乾炒牛河
干城	干城
干池	乾池
干刍	乾芻
干茨腊	乾茨臘
干此杯	乾此杯
干此坛	乾此罈
干醋	乾醋
干脆	乾脆
干村沙	乾村沙
干打雷	乾打雷
干打垒	乾打壘
干旦	乾旦
干得	幹得
干得很	乾得很
干得两杯	乾得兩杯
干得三杯	乾得三杯
干得一杯	乾得一杯
干的	乾的
干灯盏	乾燈盞
干等	乾等
干瞪眼	乾瞪眼
干地	乾地
干弟	乾弟
干点	乾點
干电	乾電
干吊着下巴	乾吊着下巴
干掉	幹掉
干掉那杯	乾掉那杯
干掉那碗	乾掉那碗
干掉一杯	乾掉一杯
干掉一瓶	乾掉一瓶
干掉一碗	乾掉一碗
干掉这杯	乾掉這杯
干掉这碗	乾掉這碗
干爹	乾爹
干断	乾斷
干儿	乾兒
干犯	干犯
干饭	乾飯
干肥	乾肥
干粉	乾粉
干干	乾乾
干纲	乾綱
干稿	乾稿
干戈	干戈
干哥	乾哥
干沟	乾溝
干股	乾股
干卦	乾卦
干馆	乾館
干果	乾果
干过	幹過
干过杯	乾過杯
干过一杯	乾過一杯
干过瘾	乾過癮
干旱	乾旱
干嚎	乾嚎
干号	乾號
干耗	乾耗
干和	乾和
干涸	乾涸
干红	乾紅
干糇	乾餱
干花	乾花
干回付	乾回付
干哕	乾噦
干货	乾貨
干霍乱	乾霍亂
干姬松茸	乾姬松茸
干急	乾急
干几杯	乾幾杯
干几手	乾幾手
干几碗	乾幾碗
干季	乾季
干将	干將
干姜	乾薑
干焦	乾焦
干酵母	乾酵母
干结	乾結
干姐	乾姐
干疥	乾疥
干尽	幹盡
干尽一杯	乾盡一杯
干尽一壺	乾盡一壺
干尽一坛	乾盡一罈
干尽一碗	乾盡一碗
干井	乾井
干净	乾淨
干淨	乾淨
干凯文	干凱文
干咳	乾咳
干渴	乾渴
干刻版	乾刻版
干枯	乾枯
干哭	乾哭
干酪	乾酪
干了	幹了
干了杯	乾了杯
干了这杯	乾了這杯
干了这碗	乾了這碗
干了这一杯	乾了這一杯
干了这一瓶	乾了這一瓶
干雷	乾雷
干冷	乾冷
干礼	乾禮
干李子	乾李子
干连	干連
干凉	乾涼
干粮	乾糧
干两杯	乾兩杯
干量	乾量
干料	乾料
干撂台	乾撂臺
干裂	乾裂
干馏	乾餾
干落	乾落
干妈	乾媽
干毛巾	乾毛巾
干冒烟	乾冒煙
干没	乾沒
干梅	乾梅
干妹	乾妹
干面	乾麪
干篾片	乾篾片
干那	幹那
干那杯	乾那杯
干那一杯	乾那一杯
干挠	干撓
干你	幹你
干你娘	幹你孃
干娘	乾孃
干奴才	乾奴才
干暖	乾暖
干女	乾女
干呕	乾嘔
干皮症	乾皮症
干啤	乾啤
干片	乾片
干撇下	乾撇下
干戚	干鏚
干漆	乾漆
干虔	乾虔
干乔	乾喬
干亲	乾親
干卿底事	干卿底事
干卿何事	干卿何事
干球温度	乾球溫度
干渠	乾渠
干扰	干擾
干热	乾熱
干熱	乾熱
干肉	乾肉
干颡	乾顙
干涩	乾澀
干烧	乾燒
干涉	干涉
干伸舌	乾伸舌
干生气	乾生氣
干生受	乾生受
干生子	乾生子
干尸	乾屍
干湿	乾溼
干湿发	乾溼髮
干时	干時
干屎橛	乾屎橛
干式	乾式
干手	幹手
干手净脚	乾手淨腳
干瘦	乾瘦
干数杯	乾數杯
干爽	乾爽
干丝	乾絲
干死	乾死
干闼婆	乾闥婆
干台	乾颱
干苔	乾薹
干坛子	乾罈子
干堂婶	乾堂嬸
干啼	乾啼
干田	乾田
干透	乾透
干图	乾圖
干土	乾土
干坞	乾塢
干洗	乾洗
干系	干係
干鲜	乾鮮
干象	乾象
干笑	乾笑
干薪	乾薪
干性	乾性
干休	干休
干癣	乾癬
干血浆	乾血漿
干哑	乾啞
干咽	乾嚥
干眼	乾眼
干曜	乾曜
干谒	干謁
干一	幹一
干一杯	乾一杯
干一坛	乾一罈
干一碗	乾一碗
干衣	乾衣
干邑	干邑
干瘾	乾癮
干硬	乾硬
干又热	乾又熱
干鱼	乾魚
干与	干與
干预	干預
干圆洁净	乾圓潔淨
干云蔽日	乾雲蔽日
干造	乾造
干燥	乾燥
干躁	乾躁
干宅	乾宅
干站着	乾站着
干折	乾折
干这	幹這
干这杯	乾這杯
干这一杯	乾這一杯
干着	幹着
干着急	乾着急
干政	干政
干支	干支
干支剌	乾支剌
干支支	乾支支
干枝	乾枝
干制	乾製
干重	乾重
干子	乾子
干姊	乾姊
干坐着	乾坐着
冈田准	岡田准
刚才	剛纔
刚干	剛乾
钢扣	鋼釦
钢梁	鋼樑
钢制	鋼製
港制	港製
杠杆	槓桿
槓杆	槓桿
高柏松	高柏松
高几	高几
高丽	高麗
高丽参	高麗蔘
高良姜	高良薑
高清愿	高清愿
高情浪海岳	高情浪海嶽
高秋南斗转	高秋南鬥轉
高郁淨	高郁淨
高政升	高政昇
高周波	高週波
糕干	糕乾
咯当	咯噹
哥里	哥里
割舍	割捨
歌尘起画梁	歌塵起畫梁
歌后	歌后
歌钟	歌鐘
格雷夫	格雷夫
格里	格里
格里高利历	格里高利曆
格里历	格里曆
格列高利历	格列高利曆
格瑞姆巴托	格瑞姆巴託
隔波望松雪	隔波望鬆雪
隔周	隔週
葛里芬	葛里芬
葛罗托斯基	葛羅托斯基
葛斯范桑	葛斯范桑
个旧	箇舊
个中	箇中
个钟	個鐘
各类	各類
各类钟	各類鐘
各里	各里
各签	各簽
根须	根鬚
根烟	根菸
跟斗	跟斗
耕获	耕穫
骾朴	骾朴
更待干罢	更待干罷
更钟	更鐘
工欲善其事	工欲善其事
工致	工緻
公布	公佈
公斗	公斗
公积金	公積金
公来雪山重	公來雪山重
公里	公里
公历	公曆
公认	公認
公认会计准	公認會計准
公孙	公孫
公孙丑	公孫丑
公仔面	公仔麪
功致	功緻
宫里	宮裏
宫里蓝	宮里藍
拱托	拱托
共铲	共剷
共和	共和
共和历	共和曆
共御外侮	共禦外侮
贡烟	貢菸
供制	供製
狗扣	狗釦
狗娘养的	狗孃養的
狗屁不通	狗屁不通
狗占马坑	狗占馬坑
狗彘不食	狗彘不食
购并	購併
购买	購買
购买欲	購買慾
咕咕	咕咕
咕咕钟	咕咕鐘
沽名	沽名
沽名干誉	沽名干譽
孤征	孤征
辜濂松	辜濂松
古迹	古蹟
古里古怪	古里古怪
古切里	古切里
古书	古書
古书云	古書云
古書云	古書云
古弦	古絃
古語云	古語云
古云	古云
古钟	古鐘
谷氨酸	穀氨酸
谷氨酰	谷氨酰
谷氨酰胺	谷氨醯胺
谷保家商	穀保家商
谷仓	穀倉
谷舱	穀艙
谷草	穀草
谷场	穀場
谷旦	穀旦
谷道	穀道
谷粉	穀粉
谷风	穀風
谷圭	穀圭
谷贵饿农	穀貴餓農
谷贵饿农谷贱伤农	穀貴餓農穀賤傷農
谷贱伤农	穀賤傷農
谷糠	穀糠
谷壳	穀殼
谷口	谷口
谷口耕岩	谷口耕岩
谷类	穀類
谷粒	穀粒
谷梁	穀梁
谷米	穀米
谷苗	穀苗
谷皮	穀皮
谷人	穀人
谷日	穀日
谷神	穀神
谷食	穀食
谷穗	穀穗
谷物	穀物
谷雨	穀雨
谷子	穀子
股栗	股慄
股栗肤粟	股栗膚粟
骨灰	骨灰
骨灰坛	骨灰罈
骨坛	骨罈
骨头	骨頭
骨头里挣出来的钱才做得肉	骨頭裏掙出來的錢纔做得肉
鼓荡	鼓盪
鼓噪	鼓譟
鹘仑吞枣	鶻崙吞棗
故侯将我到山中	故侯將我到山中
故里	故里
故人怜别日	故人憐別日
故云	故云
故宅春山中	故宅春山中
顾敌已忘生	顧敵已忘生
顾借	顧藉
瓜伊马斯	瓜伊馬斯
刮大风	颳大風
刮倒	颳倒
刮得	颳得
刮风	颳風
刮胡	刮鬍
刮了	颳了
刮起	颳起
刮去	颳去
刮须	刮鬚
刮雪	颳雪
刮着	颳着
刮走	颳走
寡欲	寡慾
挂表	掛錶
挂斗	掛斗
挂冠	掛冠
挂冠归里	掛冠歸里
挂历	掛曆
挂面	掛麪
挂钟	掛鐘
拐棒	柺棒
拐棍	柺棍
拐杖	柺杖
拐子	柺子
怪里怪气	怪里怪氣
关弓与我确	關弓與我确
关河信不通	關河信不通
关系	關係
关岳	關岳
关征	關征
观光	觀光
观光周	觀光週
官地为采	官地爲寀
官历	官曆
官准	官准
馆谷	館穀
馆娃满眼看花发	館娃滿眼看花發
管道	管道
管道升	管道昇
管弦	管絃
冠军	冠軍
冠军杯	冠軍盃
冠冕如星罗	冠冕如星羅
冠胄	冠冑
灌制	灌製
光采	光采
光杆	光桿
光卤石	光鹵石
光致	光致
光致致	光緻緻
光轴鹅不食	光軸鵝不食
咣当	咣噹
广布	廣佈
广部	广部
广舍	廣捨
归并	歸併
归及梅花发	歸及梅花發
归来使酒气	歸來使酒氣
硅质岩	硅質岩
癸丑	癸丑
柜柳	柜柳
柜台	櫃檯
贵价	貴价
桂圆	桂圓
桂圆干	桂圓乾
桂仔云	桂仔云
郭采洁	郭采潔
郭松焘	郭松燾
郭子干	郭子乾
锅伙	鍋伙
国历	國曆
国梁	國樑
国之桢干	國之楨榦
果干	果乾
果子	果子
果子干	果子乾
裹扎	裹紮
过冲	過沖
过梁	過樑
过水面	過水麪
哈贝马斯	哈貝馬斯
哈里	哈里
哈里里	哈里里
哈塔什	哈塔什
还来荆山中	還來荊山中
还辟	還辟
海参	海蔘
海淀	海淀
海干	海乾
海里	海里
海马	海馬
海马回	海馬迴
海松	海松
海鲜	海鮮
海鲜面	海鮮麪
海鲜夜排档	海鮮夜排檔
海燕双飞绕画梁	海燕雙飛繞畫梁
海于格松	海于格松
海岳名言	海岳名言
含齿戴发	含齒戴髮
含油岩	含油岩
函复	函覆
韩复矩	韓復榘
韩国	韓國
韩国制	韓國製
韩升洙	韓昇洙
韩侂胄	韓侂冑
韩制	韓製
寒泉久不通	寒泉久不通
汉弥登钟	漢彌登鐘
汉明窗	漢明窗
旱干	旱乾
旱烟	旱菸
捍御	捍禦
行不通	行不通
行境逢花发	行境逢花發
行李	行李
行李卷	行李捲
行事	行事
行事历	行事曆
行万里路胜读万卷书	行萬裏路勝讀萬捲書
行佣	行佣
行针	行鍼
行针布线	行鍼佈線
航海	航海
航海历	航海曆
蒿里	蒿里
毫发	毫髮
豪气	豪氣
豪气干云	豪氣干雲
好不	好不
好不容易	好不容易
好不容易才	好不容易纔
好干	好乾
好困	好睏
好利得	好利得
好凶	好凶
好一出	好一齣
号志	號誌
皓齿	皓齒
皓齿朱唇	皓齒硃脣
皓发	皓髮
喝采	喝采
喝倒采	喝倒采
喝干	喝乾
禾谷	禾穀
合并	合併
合吃	合吃
合儿	閤兒
合府	閤府
合家	閤家
合历	合曆
合签	合簽
合眼	閤眼
合于	合於
合于时宜	合于時宜
合中	閤中
合作	合作
合作伙伴	合作伙伴
何当怜一物	何當憐一物
何干	何干
何恨憔悴在山中	何恨憔悴在山中
何杰金氏病	何杰金氏病
何山路不通	何山路不通
何小升	何小昇
何意薄松筠	何意薄鬆筠
和奸	和姦
和面	和麪
和平	和平
和平里	和平里
和弦	和絃
劾系	劾繫
河干	河干
河里	河裏
河里孩儿岸上娘	河裏孩兒岸上孃
河升镇	河昇鎮
荷宠务推诚	荷寵務推誠
荷里活	荷里活
核保	覈保
核报	覈報
核编	覈編
核拨	覈撥
核查	覈查
核定	覈定
核对	覈對
核复	覈覆
核计	覈計
核价	覈價
核减	覈減
核批	覈批
核审	覈審
核实	覈實
核示	覈示
核收	覈收
核算	覈算
核销	覈銷
核验	覈驗
核准	覈准
核资	覈資
核字	覈字
涸干	涸乾
贺后骂殿	賀后罵殿
赫弗里希	赫弗里希
褐衣不完	褐衣不完
鹤吊	鶴弔
鹤发	鶴髮
鹤骨松姿	鶴骨松姿
黑发	黑髮
黑亮	黑亮
黑亮发	黑亮髮
黑面	黑麪
黑松	黑松
黑须	黑鬚
黑曜岩	黑曜岩
很干	很乾
横梁	橫樑
烘干	烘乾
烘托	烘托
烘熏	烘燻
烘云托月	烘雲托月
烘制	烘製
弘历	弘曆
红发	紅髮
红千层	紅千層
红绳	紅繩
红绳系足	紅繩繫足
红丝暗系	紅絲暗繫
红松	紅松
红须	紅須
红须绿眼	紅鬚綠眼
红叶	紅葉
红叶杯	紅葉盃
红钟	紅鐘
洪复	洪覆
洪沟第二	洪溝第二
洪沟第三	洪溝第三
洪升	洪昇
洪士杰	洪士杰
洪适	洪适
洪钟	洪鐘
哄动	鬨動
哄伙	鬨夥
哄闹	鬨鬧
哄然	鬨然
哄堂	鬨堂
哄笑	鬨笑
澒蒙	澒濛
喉干舌燥	喉乾舌燥
后安	後安
后安路	后安路
后摆	後襬
后北街	后北街
后帝	后帝
后发座	后髮座
后妃	后妃
后丰	后豐
后豐	后豐
后冠	后冠
后海	後海
后海湾	后海灣
后海灣	后海灣
后皇	后皇
后稷	后稷
后角	后角
后街	后街
后里	后里
后娘	後孃
后辟	后辟
后平路	后平路
后土	后土
后王	后王
后辛	后辛
后羿	后羿
后制	後製
后座	後座
后座系	後座繫
厚朴	厚朴
忽舍下	忽捨下
狐关雪复平	狐關雪復平
狐借虎威	狐藉虎威
胡碴子	鬍碴子
胡吃海喝	胡吃海喝
胡吃闷睡	胡吃悶睡
胡匪	鬍匪
胡关雪复平	胡關雪復平
胡椒	胡椒
胡椒面	胡椒麪
胡杰	胡杰
胡里胡涂	胡里胡塗
胡髯	鬍髯
胡梢	鬍梢
胡同	衚衕
胡托莫	胡托莫
胡须	鬍鬚
胡云	胡云
胡渣	鬍渣
胡髭	鬍髭
胡子	鬍子
鹄发	鵠髮
湖滨一号	湖濱一號
糊口	餬口
糊里糊涂	糊里糊塗
虎皮松	虎皮松
虎须	虎鬚
护发	護髮
戽斗	戽斗
花庵词选	花菴詞選
花采	花采
花发老	花髮老
花岗	花崗
花岗岩	花崗岩
花哄	花鬨
花胶瘦肉羹	花膠瘦肉羹
花椒	花椒
花椒面	花椒麪
花卷	花捲
花落到山中	花落到山中
花马吊嘴	花馬弔嘴
花托	花托
花药	花葯
花钟	花鐘
划不来	划不來
划船	划船
划单人艇	划單人艇
划到	劃到
划到岸	划到岸
划到江心	划到江心
划得	劃得
划得来	划得來
划动	划動
划过	劃過
划过来	划過來
划过去	划過去
划行	划行
划桨	划槳
划进	划進
划具	划具
划来	划來
划了	劃了
划了一会	划了一會
划龙舟	划龍舟
划起	划起
划拳	划拳
划双人	划雙人
划水	划水
划算	划算
划艇	划艇
划向	划向
划一	劃一
划一桨	划一槳
划着	划着
划子	划子
划走	划走
华发	華髮
华核	華覈
华里	華里
华严	華嚴
华严钟	華嚴鐘
哗的	嘩的
哗地	嘩地
哗哗	嘩嘩
哗啦	嘩啦
滑杆	滑桿
滑借	滑藉
画梁雕栋	畫樑雕棟
怀表	懷錶
怀远县	懷遠縣
怀钟	懷鐘
换挡杆	換擋桿
换档杆	換檔桿
换斗移星	換鬥移星
换发	換髮
换只	換隻
擐系	擐繫
慌里慌张	慌里慌張
皇后	皇后
皇极	皇極
皇极历	皇極曆
皇历	皇曆
皇辟	皇辟
黄东梁	黃東樑
黄豆炖猪脚	黃豆燉豬腳
黄发	黃髮
黄干黑瘦	黃乾黑瘦
黄金	黃金
黄金周	黃金週
黄俊杰	黃俊杰
黄历	黃曆
黄梁	黃梁
黄梁美梦	黃樑美夢
黄珮筑	黃珮筑
黄曲毒素	黃麴毒素
黄须	黃鬚
黄旭升	黃旭昇
黄岩	黃岩
黄郁涵	黃郁涵
黄郁茹	黃郁茹
黄育杰	黃育杰
黄钰筑	黃鈺筑
黄钟	黃鐘
黄钟毁弃	黃鐘譭棄
黃鈺筑	黃鈺筑
湟潦生苹	湟潦生苹
磺胺甲恶唑	磺胺甲惡唑
晃荡	晃盪
灰发	灰髮
灰胡	灰鬍
灰蒙	灰濛
挥涕且复去	揮涕且復去
辉丰一号	輝豐一號
辉绿岩	輝綠岩
辉长岩	輝長岩
回避	迴避
回飙	迴飆
回肠	迴腸
回冲	回沖
回带	迴帶
回荡	迴盪
回递	回遞
回递性	迴遞性
回风	迴風
回复	回覆
回光返照	迴光返照
回归	迴歸
回护	迴護
回环	迴環
回黄倒皂	回黃倒皂
回魂仙梦	迴魂仙夢
回敎会议组织	回教會議組織
回卷	回捲
回廊	迴廊
回历	回曆
回流	迴流
回路	迴路
回銮	迴鑾
回盲瓣	迴盲瓣
回梦	迴夢
回清倒影	迴清倒影
回圈	迴圈
回绕	迴繞
回声	回聲
回声探测	迴聲探測
回首望松筠	回首望鬆筠
回诵	迴誦
回天	迴天
回腕	迴腕
回文	迴文
回纹针	迴紋針
回斡	迴斡
回翔	迴翔
回响	迴響
回向	迴向
回心	迴心
回形	回形
回形夹	迴形夾
回旋	迴旋
回穴	迴穴
回雪	迴雪
回阳荡气	迴陽蕩氣
回音	迴音
回应	迴應
回佣	回佣
回游	迴游
回匝	迴匝
回转	迴轉
洄暗	洄闇
洄游	洄游
毁弃	譭棄
毁诬	譭誣
毁犀	燬犀
毁炎	燬炎
毁誉	譭譽
毁钟为铎	譭鐘爲鐸
汇报	彙報
汇编	彙編
汇集	彙集
汇辑	彙輯
汇刊	彙刊
汇算	彙算
汇映	彙映
汇整	彙整
汇总	彙總
汇纂	彙纂
会吊	會弔
会签	會籤
会签制度	會簽制度
绘里	繪里
绘制	繪製
烩面	燴麪
惠里香	惠里香
會干擾	會干擾
浑仪	渾儀
浑仪注	渾儀註
浑疑证六通	渾疑證六通
馄饨	餛飩
馄饨面	餛飩麪
活扣	活釦
活塞	活塞
活塞杆	活塞桿
火杯	火盃
火并	火併
火柴	火柴
火柴杆	火柴桿
火成岩	火成岩
火斗	火斗
火鸡腿	火雞腿
火炬	火炬
火炬松	火炬松
火山无冷地	火山無冷地
火绳	火繩
火绳杆	火繩桿
火中取栗	火中取栗
伙房	伙房
伙夫	伙伕
伙食	伙食
伙头	伙頭
或系之牛	或繫之牛
获准	獲准
霍克	霍克
霍克松	霍克松
霍里	霍里
击钟	擊鐘
饥荒	饑荒
饥馑	饑饉
饥民	饑民
饥年	饑年
机辟	機辟
机器	機器
机器人专家艾里	機器人專家艾裏
机器压制	機器壓製
机械	機械
机械表	機械錶
机械钟	機械鐘
鸡蛋	雞蛋
鸡蛋面	雞蛋麪
鸡奸	雞姦
鸡尸牛从	雞尸牛從
鸡丝	雞絲
鸡丝面	雞絲麪
鸡腿面	雞腿麪
鸡只	雞隻
积谷	積穀
积谷防饥	積穀防饑
积金至斗	積金至斗
基里巴斯	基里巴斯
基里兰柯	基里蘭柯
基岩	基岩
赍志没地	齎志沒地
箕斗	箕斗
稽核	稽覈
激荡	激盪
羁系	羈繫
吉科希斯	吉科希斯
吉里	吉里
吉普	吉普
吉普斯夸	吉普斯夸
吉田松阴	吉田松陰
吉凶	吉凶
吉凶庆吊	吉凶慶弔
吉占	吉占
急投此方可回阳	急投此方可回陽
急征重敛	急征重斂
集中	集中
集中托运	集中托運
集注	集註
几案	几案
几出	幾齣
几凳	几凳
几杆	幾桿
几几	几几
几净窗明	几淨窗明
几里在山中	幾裏在山中
几率	機率
几面上	几面上
几旁	几旁
几匹马	幾匹馬
几上	几上
几榻	几榻
几席	几席
几筵	几筵
几椅	几椅
几杖	几杖
几只	幾隻
几子	几子
己丑	己丑
虮蝨相吊	蟣蝨相弔
脊萼鹅不食	脊萼鵝不食
脊梁	脊樑
计时	計時
计时表	計時錶
纪里谷	紀里谷
纪历	紀曆
纪念	紀念
纪念周	紀念週
忌烟	忌菸
季咸	季咸
迹蹈	蹟蹈
觊幸	覬倖
祭吊	祭弔
祭尸	祭尸
加卷	加捲
加拉干达	加拉干達
加里	加里
加签	加簽
加注	加註
佳里	佳里
家伙	傢伙
家具	傢俱
家俱	傢俱
家什	傢什
家私	傢俬
傢伙	傢伙
嘉柏隆里	嘉柏隆里
嘉谷	嘉穀
夹注	夾註
颊须	頰鬚
甲基苯并恶唑	甲基苯並惡唑
甲胄	甲冑
贾大一	賈大一
贾后	賈后
贾斯伯	賈斯伯
假发	假髮
賈后	賈后
架梁	架樑
架钟	架鐘
尖管面	尖管麪
奸盗邪淫	姦盜邪淫
奸非	姦非
奸夫	姦夫
奸伏	姦伏
奸妇	姦婦
奸情	姦情
奸杀	姦殺
奸尸	姦屍
奸通	姦通
奸污	姦污
奸凶	姦凶
奸淫	姦淫
坚贞扫地无	堅貞掃地無
坚致	堅緻
间不容发	間不容髮
艰巨	艱鉅
艰苦	艱苦
艰苦备尝	艱苦備嚐
监系	監繫
监制	監製
兼并	兼併
兼筹并顾	兼籌幷顧
兼容	兼容
兼容并蓄	兼容幷蓄
兼收并蓄	兼收幷蓄
笺注	箋註
煎面	煎麪
茧栗	繭栗
俭确之教	儉确之教
检复	檢覆
剪彩	剪綵
剪发	剪髮
剪其发	剪其髮
简并	簡併
简朝仑	簡朝崙
简余晏	簡余晏
戬谷	戩穀
碱性	鹼性
碱性岩	鹼性岩
翦彩	翦綵
见复	見覆
见鉴	見鑒
件钟	件鐘
荐饥	荐饑
荐居	荐居
荐臻	荐臻
剑杆	劍桿
舰只	艦隻
鉴核备査	鑑核備查
箭杆	箭桿
江采苹	江采蘋
江城菊花发	江城菊花發
江干	江干
江干区	江乾區
江火共星罗	江火共星羅
江流思夏后	江流思夏後
姜饼	薑餅
姜茶	薑茶
姜桂	薑桂
姜还是老	薑還是老
姜黄	薑黃
姜就是老	薑就是老
姜辣	薑辣
姜老辣	薑老辣
姜麻园	薑麻園
姜末	薑末
姜母	薑母
姜片	薑片
姜切片	薑切片
姜茸柠檬锔鸡腿	姜茸檸檬鋦雞腿
姜蓉	薑蓉
姜石	姜石
姜石年	薑石年
姜是老	薑是老
姜丝	薑絲
姜汤	薑湯
姜糖	薑糖
姜文杰	姜文杰
姜郁美	姜郁美
姜愈老愈辣	薑愈老愈辣
姜越老越辣	薑越老越辣
姜汁	薑汁
僵蚕	殭蠶
僵仆	僵仆
僵尸	殭屍
彊御	彊禦
奖杯	獎盃
交臂失之	交臂失之
交并	交併
交哄	交鬨
浇制	澆製
胶卷	膠捲
焦干	焦乾
焦获	焦穫
礁岩	礁岩
嚼谷	嚼穀
角里	角里
绞干	絞乾
矫情	矯情
矫情干誉	矯情干譽
脚夫	腳伕
脚扣	腳釦
脚炼	腳鍊
脚酸	腳痠
脚注	腳註
儌幸	儌倖
徼幸	徼倖
轿夫	轎伕
教学	教學
教学钟	教學鐘
接二连三	接二連三
嗟吁	嗟吁
街里街坊	街里街坊
节操方松筠	節操方鬆筠
节欲	節慾
杰弗里乔叟	傑弗里喬叟
杰里米	傑里米
杰里森	傑里森
杰伦	杰倫
杰特	杰特
拮据	拮据
结采	結采
结彩	結綵
结发	結髮
结晶	結晶
结晶岩	結晶岩
结扣	結釦
结托	結托
结扎	結紮
截发	截髮
解发	解發
解发佯狂	解髮佯狂
解扣	解釦
解铃系铃	解鈴繫鈴
介系词	介係詞
介胄	介冑
戒烟	戒菸
借草枕块	藉草枕塊
借词	藉詞
借此	藉此
借端	藉端
借槁	藉槁
借故	藉故
借卉	藉卉
借机	藉機
借借	藉藉
借口	藉口
借寇兵	藉寇兵
借甚	藉甚
借手	藉手
借托	借托
借以	藉以
借由	藉由
借着	藉着
借助	藉助
借箸	借箸
借箸代筹	藉箸代籌
借资	藉資
斤斗	斤斗
金杯	金盃
金表	金錶
金伯利	金伯利
金伯利岩	金伯利岩
金斗	金斗
金发	金髮
金虎皮	金虎皮
金开诚	金開誠
金链	金鍊
金仑溪	金崙溪
金马	金馬
金马仑道	金馬崙道
金钱	金錢
金钱松	金錢松
金升圭	金昇圭
金石普利	金石普利
金属	金屬
金属杆	金屬桿
金属制	金屬製
金印	金印
金印如斗	金印如斗
金钟	金鐘
觔斗	觔斗
津梁	津樑
筋斗	筋斗
紧系	緊繫
紧致	緊緻
锦鳞沉不食	錦鱗沉不食
锦囊佳制	錦囊佳製
尽底下	儘底下
尽够	儘夠
尽管	儘管
尽教	儘教
尽尽	儘儘
尽可	儘可
尽快	儘快
尽里	儘裏
尽量	儘量
尽落尾	儘落尾
尽让	儘讓
尽日吟诗坐忍饥	盡日吟詩坐忍飢
尽速	儘速
尽先	儘先
尽想	儘想
尽性	儘性
尽意	盡意
尽意随心	儘意隨心
尽有可能	儘有可能
尽早	儘早
尽子	儘子
尽自	儘自
近日	近日
近日無仇	近日無讎
浸制	浸製
禁毁	禁燬
禁烟	禁菸
禁欲	禁慾
经颅多普勒	經顱多普勒
经折	經摺
荆尸	荊尸
菁英杯	菁英盃
旌恤	旌卹
惊叹	驚歎
惊赞	驚讚
惊钟	驚鐘
精采	精采
精奇	精奇
精奇里江	精奇里江
精制	精製
精致	精緻
鲸须	鯨鬚
井干	井榦
井渫不食	井渫不食
颈链	頸鍊
景星凤皇	景星鳳皇
景致	景緻
警报	警報
警报钟	警報鐘
警示	警示
警示钟	警示鐘
警世	警世
警世钟	警世鐘
警钟	警鐘
净发	淨髮
淨发	淨髮
敬鉴	敬鑒
敬挽	敬輓
敬烟	敬菸
靖远县	靖遠縣
迥然	迥然
迥然回异	迥然迴異
揪发	揪髮
揪须	揪鬚
九点半	九點半
九谷	九穀
九里	九里
九炼成钢	九鍊成鋼
九龙一号	九龍一號
九牛一毫	九牛一毫
九扎	九紮
九只	九隻
酒干掉	酒乾掉
酒干尽	酒乾盡
酒干了	酒乾了
酒帘	酒帘
酒气熏人	酒氣熏人
酒曲	酒麴
酒坛	酒罈
酒已干	酒已乾
酒游花	酒游花
旧表	舊錶
旧历	舊曆
旧浦菱花发	舊浦菱花發
旧宅在山中	舊宅在山中
旧钟	舊鐘
就吃干	就吃乾
就系	就係
拘系	拘繫
居里	居里
居然双捕虏	居然雙捕虜
局促	侷促
局限	侷限
咀咽	咀嚥
莒光周	莒光週
举荐	舉薦
举荐征辟	舉薦征辟
举手	舉手
举手可采	舉手可采
巨变	鉅變
巨额	鉅額
巨富	鉅富
巨公	鉅公
巨奸	鉅奸
巨舰	鉅艦
巨奖	鉅獎
巨款	鉅款
巨亏	鉅虧
巨鹿	鉅鹿
巨商	鉅商
巨黍	鉅黍
巨贪	鉅貪
巨万	鉅萬
巨细	鉅細
巨献	鉅獻
巨祥	鉅祥
巨野	鉅野
巨业	鉅業
巨债	鉅債
巨制	鉅製
巨著	鉅著
巨子	鉅子
巨作	鉅作
拒烟	拒菸
据干而窥井底	據榦而窺井底
据云	據云
聚药	聚藥
聚药雄蕊	聚葯雄蕊
卷包	捲包
卷饼	捲餅
卷不起	捲不起
卷層云	捲層雲
卷缠	捲纏
卷成	捲成
卷尺	捲尺
卷到	捲到
卷动	捲動
卷发	捲髮
卷风	捲風
卷钢	捲鋼
卷过	捲過
卷回	捲回
卷甲	卷甲
卷甲重来	捲甲重來
卷进	捲進
卷开	捲開
卷款	捲款
卷来	捲來
卷来卷去	捲來捲去
卷浪	捲浪
卷了	捲了
卷帘	捲簾
卷拢	捲攏
卷落叶	捲落葉
卷毛	捲毛
卷棚	捲棚
卷铺盖	捲鋪蓋
卷舖盖	捲舖蓋
卷起	捲起
卷翘	捲翹
卷曲	捲曲
卷去	捲去
卷刃	捲刃
卷入	捲入
卷上	捲上
卷舌	捲舌
卷缩	捲縮
卷逃	捲逃
卷筒	捲筒
卷图	捲圖
卷土	捲土
卷腿裤	捲腿褲
卷尾猴	捲尾猴
卷吸作用	捲吸作用
卷线器	捲線器
卷心	捲心
卷袖	捲袖
卷须	卷鬚
卷旋	捲旋
卷烟	捲菸
卷烟画片	捲煙畫片
卷菸	捲菸
卷扬	捲揚
卷一卷	捲一捲
卷衣袖	捲衣袖
卷云	捲雲
卷纸	捲紙
卷住	捲住
卷走	捲走
绝缘	絕緣
绝缘台	絕緣檯
军舰	軍艦
军舰岩	軍艦岩
君子	君子
君子于役	君子于役
钧复	鈞覆
钧鉴	鈞鑒
菌托	菌托
喀拉喀托火山	喀拉喀托火山
卡里	卡里
卡里扎德	卡里紮德
卡洛	卡洛
卡洛里	卡洛里
卡通公仔	卡通公仔
卡托普利	卡託普利
卡耶里	卡耶里
开诚布公	開誠佈公
开吊	開弔
开发为	開發爲
开哄	開鬨
开伙	開伙
揩干	揩乾
揩台抹凳	揩檯抹凳
凯里	凱里
铠胄	鎧冑
刊布	刊佈
看表	看錶
看看几花发	看看幾花發
看下表	看下錶
看下钟	看下鐘
看钟	看鐘
康采恩	康采恩
扛大梁	扛大樑
抗御	抗禦
炕席	炕蓆
考核	考覈
考历明三统	考歷明三統
烤干	烤乾
珂里	珂里
柯里	柯里
科斗	科斗
科托努	科托努
科学	科學
科学面	科學麪
蚵仔	蚵仔
蚵仔面线	蚵仔麪線
可干拭	可乾拭
可干饮	可乾飲
可可	可可
可可托海	可可托海
可周	可週
克薄	剋薄
克剥	剋剝
克夫	剋夫
克核	剋核
克克	剋剋
克扣	剋扣
克莱	克萊
克莱査克	克萊查克
克雷希斯	克雷希斯
克雷一号	克雷一號
克里	克里
克里斯蒂安松	克里斯蒂安松
克里斯托	克里斯托
克里特克里岛	克里特克里島
克落	剋落
克期	剋期
克日	剋日
克啬	剋嗇
克死	剋死
克星	剋星
克意	剋意
克制	剋制
刻半钟	刻半鐘
刻多钟	刻多鐘
刻钟	刻鐘
峇峇娘惹	峇峇孃惹
峇里岛	峇里島
客制化	客製化
垦丁杯	墾丁盃
垦复	墾複
空蒙	空濛
空前	空前
空前绝后	空前絕後
空前绝后后	空前絕后後
空钟	空鐘
涳蒙	涳濛
孔章望斗	孔章望斗
控卷	控捲
控制	控制
控制杆	控制桿
控制台	控制檯
控制欲	控制慾
口出大言	口出大言
口干	口乾
口念	口唸
口燥脣干	口燥脣乾
口占	口占
口钟	口鐘
叩钟	叩鐘
扣环	釦環
扣克	扣剋
扣眼	釦眼
扣针	釦針
扣子	釦子
枯干	枯乾
苦参	苦蔘
苦瓜	苦瓜
苦瓜干	苦瓜乾
苦卤	苦鹵
裤扣	褲釦
夸诞	夸誕
夸尔	夸爾
夸父	夸父
夸姣	夸姣
夸克	夸克
夸丽	夸麗
夸毗	夸毗
夸人	夸人
夸容	夸容
夸特	夸特
夸脱	夸脫
夸赞	誇讚
快吃干	快吃乾
快干	快乾
快舍下	快捨下
快速	快速
快速面	快速麪
狂并潮	狂併潮
奎松市	奎松市
喹那普利	喹那普利
坤表	坤錶
昆剧	崑劇
昆仑	崑崙
昆腔	崑腔
昆曲	崑曲
昆山	崑山
昆苏	崑蘇
昆调	崑調
崑仑	崑崙
髡发	髡髮
捆扎	捆紮
綑扎	綑紮
困乏	睏乏
困觉	睏覺
困倦	睏倦
困意	睏意
括发	括髮
拉大旗作虎皮	拉大旗作虎皮
拉杆	拉桿
拉吉波尔	拉吉波爾
拉克	拉克
拉克施尔德钟	拉克施爾德鐘
拉里	拉里
拉链	拉鍊
拉面	拉麪
拉涅里	拉涅里
拉升	拉昇
拉斯帕尔马斯	拉斯帕爾馬斯
拉纤	拉縴
拉扎尔	拉扎爾
拉祖里	拉祖里
邋里邋遢	邋里邋遢
腊之以为饵	腊之以爲餌
蜡査	蠟查
蜡祭	蜡祭
蜡月	蜡月
辣椒	辣椒
辣椒面	辣椒麪
来复	來複
来为采葑菲	來爲採葑菲
莱彩	萊彩
莱彩北堂	萊綵北堂
莱里达	萊里達
赖诺普利	賴諾普利
栏干	欄干
阑干	闌干
蓝采和	藍采和
蓝发	藍髮
蓝托斯	藍托斯
篮虹杯	籃虹盃
啷当	啷噹
狼餐虎咽	狼餐虎嚥
狼飧虎咽	狼飧虎嚥
狼吞虎咽	狼吞虎嚥
浪蝶	浪蝶
浪蝶游蜂	浪蝶游蜂
浪琴表	浪琴錶
捞干	撈乾
捞面	撈麪
劳力	勞力
劳力士表	勞力士錶
劳生系一物	勞生系一物
老板	老闆
老雕	老鵰
老斗	老斗
老官地	老官地
老虎皮	老虎皮
老姜	老薑
老蒙	老懞
老娘	老孃
老雁春忍饥	老雁春忍飢
老爷	老爺
老爷钟	老爺鐘
乐颠颠	樂顛顛
乐器	樂器
乐器钟	樂器鐘
泐复	泐覆
勒里勒得	勒里勒得
了解	瞭解
了了见松雪	了了見鬆雪
了然	瞭然
了如	瞭如
了若指掌	瞭若指掌
了望	瞭望
雷出应乾象	雷出應乾象
雷夫范恩斯	雷夫范恩斯
雷米普利	雷米普利
诔赞	誄讚
泪干	淚乾
冷地里	冷地里
冷面	冷麪
厘金	厘金
梨干	梨乾
漓江	灕江
漓然	灕然
漓水	灕水
漓湘	灕湘
蠡湖一号	蠡湖一號
礼斗	禮斗
礼赞	禮讚
李干龙	李乾龍
李连杰	李連杰
李連杰	李連杰
李链福	李鍊福
李盟干	李盟乾
李三娘	李三娘
李钟奭	李鐘奭
李钟郁	李鍾郁
李锺郁	李鍾郁
里昂	里昂
里奥	里奧
里包恩	里包恩
里贝利	里貝利
里布	里布
里程	里程
里程表	里程錶
里党	里黨
里尔	里爾
里耳	里耳
里弗赛德	里弗賽德
里港	里港
里根	里根
里闬	里閈
里豪	里豪
里肌	里肌
里加	里加
里贾纳	里賈納
里居	里居
里君	里君
里科	里科
里克	裏克
里克特	里克特
里扣	里扣
里拉	里拉
里老	里老
里邻长	里鄰長
里路	里路
里闾	里閭
里美	里美
里门	里門
里蒙诺夫	里蒙諾夫
里民	里民
里名	里名
里纳	里納
里尼	里尼
里弄	里弄
里欧	里歐
里奇	裏奇
里奇蒙	里奇蒙
里契蒙	里契蒙
里人	里人
里仁	里仁
里舍	里舍
里社	里社
里士满	里士滿
里氏	里氏
里斯	里斯
里谈巷议	里談巷議
里特维宁科	里特維寧科
里瓦几亚条约	里瓦幾亞條約
里维拉	里維拉
里希特霍芬	里希特霍芬
里巷	里巷
里胥	里胥
里亚	里亞
里谚	里諺
里语	里語
里约	里約
里宰	里宰
里长	里長
里正	里正
里兹	里茲
理次发	理次髮
理发	理髮
理个	理個
理个发	理個髮
理事	理事
理事长	理事長
理事长杯	理事長盃
理完发	理完髮
理一次发	理一次髮
理一个发	理一個髮
力征	力征
历本	曆本
历法	曆法
历纪	曆紀
历命	曆命
历始	曆始
历室	曆室
历书	曆書
历头	曆頭
历尾	曆尾
历象	曆象
历狱	曆獄
历元	曆元
立方	立方
立方厘米	立方厘米
利得汇	利得彙
利默里克	利默里克
利托	利托
利欲	利慾
沥干	瀝乾
俪采	儷采
栗苞	栗苞
栗暴	栗暴
栗爆	栗爆
栗喇	栗喇
栗烈	栗烈
栗碌	栗碌
栗色	栗色
栗鼠	栗鼠
栗田雄介	栗田雄介
栗尾	栗尾
栗薪	栗薪
栗凿	栗鑿
栗子	栗子
砾岩	礫岩
粒变岩	粒變岩
连杆	連桿
连三并四	連三併四
连系	連繫
莲须	蓮鬚
联赛	聯賽
联赛杯	聯賽盃
联系	聯繫
镰仓	鎌倉
炼度	鍊度
炼钢	鍊鋼
炼汞	鍊汞
炼金	鍊金
炼铝	鍊鋁
炼贫	鍊貧
炼师	鍊師
炼铁	鍊鐵
炼铜	鍊銅
炼冶	鍊冶
炼制	煉製
链甲	鍊甲
链扣	鏈釦
链形	鍊形
链坠	鍊墜
良价	良价
凉面	涼麪
凉席	涼蓆
梁栋	樑棟
梁架	樑架
梁龙	樑龍
梁木	梁木
梁木其坏	樑木其壞
梁上	樑上
梁文冲	梁文沖
梁柱	樑柱
梁子	樑子
两当一	兩當一
两京路上梅花发	兩京路上梅花發
两撇胡	兩撇鬍
两扎	兩紮
两只	兩隻
两周	兩週
亮钟	亮鐘
晾干	晾乾
辽沈	遼瀋
聊乐一日	聊樂一日
寮采	寮寀
燎发	燎髮
料斗	料斗
廖于诚	廖于誠
邻里	鄰里
林冲	林沖
林端陟香榭	林端陟香榭
林芳郁	林芳郁
林干闵	林乾閔
林杰梁	林杰樑
林俊杰	林俊杰
林荣松	林榮松
林松	林松
林与西山重	林與西山重
林郁方	林郁方
林占梅	林占梅
林正杰	林正杰
林钟	林鐘
临海	臨海
临海水土志	臨海水土誌
临行一日绕千回	臨行一日繞千回
淋冲	淋沖
磷酸	磷酸
磷酸盐	磷酸鹽
磷酸盐岩	磷酸鹽岩
鳞介腥膻素不食	鱗介腥羶素不食
鳞游	鱗游
躏借	躪藉
灵迹	靈蹟
灵修	靈脩
灵欲	靈慾
凌策	淩策
凌昌焕	淩昌焕
凌驰	淩馳
凌河	淩河
凌惠平	淩惠平
凌借	凌藉
凌蒙初	淩濛初
凌如焕	淩如焕
凌十八	淩十八
凌氏	淩氏
凌水	淩水
凌统	淩統
凌退思	淩退思
凌小姐	淩小姐
凌姓	淩姓
凌云	凌雲
凌云翰	淩云翰
凌志	凌志
凌志美	淩志美
零只	零隻
领扣	領釦
领台	領檯
领袖	領袖
领袖欲	領袖慾
令狐冲	令狐沖
令岳	令岳
溜须	溜鬚
刘峰松	劉峯松
刘福生	劉福生
刘松藩	劉松藩
刘松年	劉松年
刘伟杰	劉偉杰
刘幸如	劉倖如
刘占吉	劉占吉
刘志升	劉志昇
留发	留髮
流布	流佈
流干	流乾
流纹岩	流紋岩
流血	流血
流血浮尸	流血浮尸
流血漂卤	流血漂鹵
柳斌杰	柳斌杰
柳升耀	柳昇耀
六冲	六沖
六谷	六穀
六通四辟	六通四辟
六弦	六絃
六须鲇	六鬚鮎
六须鲶	六鬚鮎
六欲	六慾
六扎	六紮
六只	六隻
六周	六週
龙卷	龍捲
龙虾	龍蝦
龙虾面	龍蝦麪
龙须	龍鬚
龙须面	龍鬚麪
龙游	龍遊
龙游浅水	龍游淺水
砻谷	礱谷
砻谷机	礱穀機
癃闭不通	癃閉不通
镂金错采	鏤金錯采
漏斗	漏斗
噜噜苏苏	嚕嚕囌囌
噜苏	嚕囌
卢贝松	盧貝松
卢郁佳	盧郁佳
芦席	蘆蓆
卤簿	鹵簿
卤代烃	鹵代烴
卤地	鹵地
卤钝	鹵鈍
卤化	鹵化
卤鸡腿	滷雞腿
卤莽	鹵莽
卤面	滷麪
卤人	鹵人
卤素	鹵素
卤制	滷製
卤族	鹵族
鲁伊马拉	魯伊馬拉
甪里	甪里
陆均松	陸均松
陆游	陸游
录录	彔彔
录制	錄製
鹿门	鹿門
鹿门采药	鹿門采藥
鹿裘长酒气	鹿裘長酒氣
路飞秋叶转朱轓	路飛秋葉轉朱轓
路里	路里
路志	路誌
露复	露覆
露井桃花发	露井桃花發
乱发	亂髮
乱哄	亂鬨
仑背	崙背
仑丰村	崙豐村
轮回	輪迴
轮奸	輪姦
罗尔斯罗伊斯	羅爾斯羅伊斯
罗汉	羅漢
罗汉松	羅漢松
罗兴梁	羅興樑
萝卜	蘿蔔
萝卜干	蘿蔔乾
螺杆	螺桿
螺普利	螺普利
螺旋	螺旋
螺旋面	螺旋麪
裸岩	裸岩
荦确	犖确
洛钟东应	洛鐘東應
络腮胡	絡腮鬍
落发	落髮
落日忆山中	落日憶山中
落腮胡	落腮鬍
落托	落托
落叶	落葉
落叶松	落葉松
囉囉苏苏	囉囉囌囌
囉苏	囉囌
驴蒙虎皮	驢蒙虎皮
闾里	閭里
吕后	呂后
吕宋烟	呂宋菸
吕岩	呂岩
呂后	呂后
郘钟	郘鐘
捋采	捋采
铝制	鋁製
屡仆屡起	屢仆屢起
律历志	律曆志
绿发	綠髮
绿杨深处是苏家	綠楊深處是蘇家
氯苯并恶唑	氯苯並惡唑
麻杆	麻桿
麻酱	麻醬
麻酱凤尾	麻醬鳳尾
麻酱面	麻醬麪
麻栗坡	麻栗坡
马表	馬錶
马大周	馬大周
马丁	馬丁
马丁杜里荷	馬丁杜里荷
马夫	馬伕
马干	馬乾
马后	馬後
马后练服	馬后練服
马克斯型机器人一号	馬克斯型機器人一號
马拉巴栗	馬拉巴栗
马拉松	馬拉松
马里	馬裏
马里安纳海沟	馬里安納海溝
马里克	馬里克
马里兰	馬里蘭
马里内斯科	馬里內斯科
马里奇	馬里奇
马鬣松	馬鬣松
马尼托巴	馬尼托巴
马普托	馬普托
马斯垂克	馬斯垂剋
马尾	馬尾
马尾松	馬尾松
马兴云	馬興雲
马扎	馬紮
马占山	馬占山
玛艾里	瑪艾裏
玛格莉娜蛇纹	瑪格莉娜蛇紋
码表	碼錶
馬占山	馬占山
埋布	埋佈
埋头	埋頭
埋头寻表	埋頭尋錶
埋头寻钟	埋頭尋鐘
买进	買進
买进对冲	買進對沖
买烟	買菸
迈科里	邁科里
麦卡托	麥卡托
麦科里	麥科里
麦托姆	麥托姆
卖拐	賣柺
卖奸	賣姦
卖鲊市中何许人	賣鮓市中何許人
脉岩	脈岩
颟里颟顸	顢里顢頇
满布	滿布
满布疑云	滿佈疑雲
满头洋发	滿頭洋髮
满洲里	滿洲里
曼尼	曼尼
曼尼托巴省	曼尼托巴省
幔城入涧橙花发	幔城入澗橙花發
慢咽	慢嚥
忙并	忙併
莽卤	莽鹵
毛发	毛髮
毛姜	毛薑
毛里求斯	毛里求斯
毛里塔尼亚	毛里塔尼亞
毛绒公仔	毛絨公仔
毛轴鹅不食	毛軸鵝不食
茅屋采椽	茅屋採椽
茂松	茂松
贸易	貿易
贸易伙伴	貿易伙伴
没采	沒采
没地里	沒地里
没爹没娘	沒爹沒孃
没精打采	沒精打采
没量斗	沒量斗
没签	沒簽
没折至	沒摺至
梅干	梅乾
梅里	梅里
媒人	媒人
媒人口无量斗	媒人口無量斗
每隔一日	每隔一日
每个树边消一日	每個樹邊消一日
每只	每隻
每周	每週
美发	美髮
美国	美國
美国制	美國製
美后	美后
美里	美里
美仑	美崙
美人美于玉	美人美於玉
美制	美製
美洲	美洲
美洲杯	美洲盃
门斗	門斗
闷表	悶錶
蒙巴拉	蒙巴拉
蒙蔽	矇蔽
蒙懂	懞懂
蒙鸿	濛鴻
蒙混	矇混
蒙聩	矇聵
蒙眬	矇矓
蒙昧	矇昧
蒙昧不清	濛昧不清
蒙蒙	濛濛
蒙蒙懂懂	懞懞懂懂
蒙蒙黑	矇矇黑
蒙蒙亮	矇矇亮
蒙蒙眬眬	矇矇矓矓
蒙骗	矇騙
蒙事	矇事
蒙汜	濛汜
蒙松雨	濛鬆雨
蒙瞍	矇瞍
蒙头	矇頭
蒙托罗拉	蒙托羅拉
蒙雾	濛霧
蒙眼	矇眼
蒙在	蒙在
蒙在鼓里	矇在鼓裏
蒙直	懞直
蒙住	矇住
孟德尔	孟德爾
孟德尔松	孟德爾松
孟加拉	孟加拉
梦回	夢迴
梦兰叶吉	夢蘭叶吉
梦系	夢繫
梦有五不占	夢有五不占
咪达普利	咪達普利
弥漫	瀰漫
弥蒙	彌矇
弥弥	瀰瀰
弥山遍野	瀰山遍野
迷奸	迷姦
迷蒙	迷濛
縻系	縻繫
米德尔伯里	米德爾伯裏
米谷	米穀
米里	米里
米面	米麪
米瑟雷希斯	米瑟雷希斯
秘制	祕製
密布	密佈
密折	密摺
密致	密緻
棉制	棉製
免胄	免冑
面霸	麪霸
面白无须	面白無鬚
面包	麪包
面饼	麪餅
面茶	麪茶
面厂	麪廠
面点	麪點
面店	麪店
面坊	麪坊
面肥	麪肥
面粉	麪粉
面缸	麪缸
面疙瘩	麪疙瘩
面馆	麪館
面糊	麪糊
面灰	麪灰
面价	麪價
面浆	麪漿
面酱	麪醬
面饺	麪餃
面筋	麪筋
面码儿	麪碼兒
面坯	面坯
面坯儿	麪坯兒
面皮	麪皮
面票	麪票
面人	麪人
面食	麪食
面塑	麪塑
面摊	麪攤
面汤	麪湯
面条	麪條
面团	麪糰
面碗	麪碗
面向	面向
面向对象	面向對象
面向对象的	面向對象的
面向对象的技术	面嚮對象的技術
面向对象语言	面嚮對象語言
面誉	面譽
面誉背毁	面譽背譭
面皂	面皂
面杖	麪杖
面子	面子
面子药	麪子藥
苗栗	苗栗
秒表	秒錶
秒钟	秒鐘
灭幼脲一号	滅幼脲一號
民政	民政
民政里	民政里
民族	民族
民族志	民族誌
闵采尔	閔采爾
闵凶	閔凶
抿发	抿髮
名表	名錶
名复金瓯	名覆金甌
明査暗访	明查暗訪
明窗几净	明窗幾淨
明窗净几	明窗淨几
明窗淨几	明窗淨几
明复	明覆
明伙画供	明伙畫供
明扣	明釦
明了	明瞭
明年此地看花发	明年此地看花發
明时正可干	明時正可幹
鸣钟	鳴鐘
冥凌	冥淩
冥蒙	冥濛
溟蒙	溟濛
谬赞	謬讚
摸钟	摸鐘
嫫母衣锦	嫫母衣錦
摹扎特	摹紮特
模里西斯	模里西斯
模制	模製
摩根	摩根
摩根费里曼	摩根費里曼
摩里西斯	摩里西斯
摩托	摩托
磨变岩	磨變岩
磨炼	磨鍊
磨制	磨製
魔表	魔錶
抹干	抹乾
莫干山	莫干山
莫吉托	莫吉托
莫里	莫里
莫信梅花发	莫信梅花發
莫余毒也	莫余毒也
墨荡子	墨盪子
墨斗	墨斗
墨沈	墨沈
墨沈未干	墨瀋未乾
默念	默唸
某只	某隻
母后	母后
母钟	母鐘
木梁	木樑
木偶	木偶
木偶戏	木偶戲
木偶戏扎	木偶戲紮
木制	木製
木钟	木鐘
目牛游刃	目牛游刃
目眩神摇	目眩神搖
墓志	墓誌
穆罕默德	穆罕默德
穆罕默德历	穆罕默德曆
拿坡里	拿坡里
拿破仑	拿破崙
拿下	拿下
拿下表	拿下錶
拿下钟	拿下鐘
拿贼要赃拿奸要双	拿賊要贓拿姦要雙
哪一出	哪一齣
哪只	哪隻
那出电影	那齣電影
那出好戏	那齣好戲
那出剧	那齣劇
那个	那個
那个猫儿不吃腥	那個貓兒不吃腥
那卷	那捲
那只	那隻
纳采	納采
乃里	乃里
奶卷	奶捲
奶娘	奶孃
萘基苯基恶唑	萘基苯基惡唑
男儿悬弧非一日	男兒懸弧非一日
男用表	男用錶
南宫	南宮
南宫适	南宮适
南回	南迴
南京	南京
南京钟	南京鐘
南里	南里
南泠路不通	南泠路不通
南山	南山
南山杯	南山盃
南巡务逸游	南巡務逸遊
南亚松	南亞鬆
南征	南征
南筑	南筑
难挨	難捱
难舍	難捨
难咽	難嚥
难荫	難廕
闹表	鬧錶
闹哄	鬧鬨
闹钟	鬧鐘
内哄	內鬨
内脏	內臟
内制	內製
能舍	能捨
能征惯战	能征慣戰
能征善战	能征善戰
尼采	尼采
尼克	尼克
尼克松	尼克松
尼亚加拉	尼亞加拉
尼亚美	尼亞美
泥灰	泥灰
泥灰岩	泥灰岩
泥岩	泥岩
泥质	泥質
泥质岩	泥質岩
倪嗣冲	倪嗣沖
拟制	擬製
你才子发昏	你纔子發昏
你斗了胆	你斗了膽
你系	你係
逆钟	逆鐘
惄如调饥	惄如調饑
拈须	拈鬚
年谷	年穀
年历	年曆
年年十月梅花发	年年十月梅花發
捻须	捻鬚
捻针	捻鍼
念啊	唸啊
念吧	唸吧
念白	唸白
念错	唸錯
念叨	唸叨
念到	唸到
念的	唸的
念对	唸對
念佛	唸佛
念经	唸經
念了	唸了
念念	念念
念念有词	唸唸有詞
念诗	唸詩
念书	唸書
念诵	唸誦
念完	唸完
念曰	唸曰
念咒	唸咒
念作	唸作
娘的	孃的
娘儿	孃兒
娘家	孃家
娘舅	孃舅
娘老子	孃老子
娘亲	孃親
娘胎	孃胎
娘姨	孃姨
酿制	釀製
鸟松	鳥松
袅袅	嫋嫋
袅袅炊烟	裊裊炊煙
袅袅上升	裊裊上升
袅绕	裊繞
袅窕	裊窕
尿斗	尿斗
捏制	捏製
宁成子	甯成子
宁辞旧路驾朱轓	寧辭舊路駕朱轓
宁悼子	甯悼子
宁斧成	甯斧成
宁浩	甯浩
宁惠子	甯惠子
宁猛力	甯猛力
宁戚	甯戚
宁调元	甯調元
宁武	寧武
宁武子	甯武子
宁远县	寧遠縣
宁越	甯越
宁中	寧中
宁中则	甯中則
宁庄子	甯莊子
凝灰岩	凝灰岩
凝炼	凝鍊
拧干	擰乾
牛骥同皂	牛驥同皂
牛柳	牛柳
牛柳面	牛柳麪
牛肉	牛肉
牛肉羹	牛肉羹
牛肉面	牛肉麪
牛只	牛隻
纽扣	鈕釦
钮扣	鈕釦
拗别	拗彆
农历	農曆
农民	農民
农民历	農民曆
浓发	濃髮
浓郁	濃郁
醲郁	醲郁
弄干	弄乾
弄鬼	弄鬼
弄鬼吊猴	弄鬼弔猴
弄面吃	弄麪吃
奴儿干	奴兒干
奴隔荷花路不通	奴隔荷花路不通
怒发冲冠	怒髮衝冠
怒发冲天	怒髮沖天
怒气	怒氣
怒气冲发	怒氣沖發
暖荡撩锅	暖盪撩鍋
诺里	諾里
糯米	糯米
糯米团	糯米糰
女丑	女丑
女生	女生
女生外向	女生外嚮
欧巴托	歐巴託
欧比斯迪	歐比斯迪
欧伯托	歐伯托
欧几里得	歐幾里得
欧几里德	歐幾里德
欧里庇得斯	歐里庇得斯
欧里桑	歐里桑
欧洲	歐洲
欧洲杯	歐洲盃
藕复	藕覆
帕累托法则	帕累托法則
帕累托最优	帕累托最優
拍出	拍出
拍出好戏	拍齣好戲
拍台拍凳	拍檯拍凳
排档杆	排檔桿
排骨	排骨
排骨面	排骨麪
排须	排鬚
徘回	徘迴
潘威志	潘威誌
潘岳	潘岳
盘回	盤迴
盘松	盤松
蟠采	蟠采
蟠龙	蟠龍
蟠龙松	蟠龍松
旁注	旁註
匏系	匏繫
跑跑颠颠	跑跑顛顛
跑台子	跑檯子
泡面	泡麪
泡制	泡製
炮制	炮製
陪吊	陪弔
培哚普利	培哚普利
培尔松	培爾松
培里克里斯	培里克里斯
裴里诺	裴里諾
裴松之	裴松之
配膳	配膳
配膳台	配膳檯
配制	配製
砰当	砰噹
烹制	烹製
彭咸	彭咸
彭于晏	彭于晏
蓬发	蓬髮
篷盖布	篷蓋佈
膨土岩	膨土岩
碰钟	碰鐘
批复	批覆
批核	批覈
批回	批迴
批注	批註
批准	批准
披发	披髮
披复	披覆
披红	披紅
披红挂彩	披紅掛綵
披头散发	披頭散髮
披云卧松雪	披雲臥鬆雪
披榛采兰	披榛採蘭
劈里	劈里
皮托管	皮托管
皮制	皮製
毗婆尸佛	毗婆尸佛
疲困	疲睏
埤塘里	埤塘里
脾脏	脾臟
匹马只轮	匹馬隻輪
辟恶	辟惡
辟咡	辟咡
辟谷	辟穀
辟举	辟舉
辟君三舍	辟君三舍
辟历施鞭	辟歷施鞭
辟纑	辟纑
辟逻	辟邏
辟命	辟命
辟匿	辟匿
辟辟	闢辟
辟然	辟然
辟人之士	辟人之士
辟色	辟色
辟世	辟世
辟书	辟書
辟违	辟違
辟邪	辟邪
辟言	辟言
辟易	辟易
辟淫	辟淫
辟引	辟引
辟雍	辟雍
辟廱	辟廱
辟召	辟召
辟支佛	辟支佛
辟芷	辟芷
偏信	偏信
偏信则暗	偏信則闇
偏幸	偏倖
片麻岩	片麻岩
片言	片言
片言只语	片言隻語
片岩	片岩
片语只辞	片語隻辭
漂荡	漂盪
漂游	漂游
飘仙一号	飄仙一號
撇吊	撇弔
拚舍	拚捨
贫女铜钗惜于玉	貧女銅釵惜於玉
品尝	品嚐
品汇	品彙
平康	平康
平康里	平康里
平生未许人	平生未許人
平远县	平遠縣
评核	評覈
评注	評註
苹果粟米鸡肉羹	蘋果粟米雞肉羹
苹萦	苹縈
凭吊	憑弔
凭几	憑几
凭借	憑藉
凭闲	憑閑
凭折	憑摺
颇复	頗覆
破表	破錶
破坏	破壞
破坏欲	破壞慾
破死忘生	破死忘生
掊斗折衡	掊斗折衡
裒克	裒剋
扑冬	撲鼕
铺盖	鋪蓋
铺盖卷儿	鋪蓋捲兒
噗噜噜	噗嚕嚕
仆倒	仆倒
仆地	仆地
仆夫	僕伕
仆街	仆街
仆然	仆然
葡萄	葡萄
葡萄干	葡萄乾
蒲松龄	蒲松齡
朴茨茅斯	朴茨茅斯
朴刀	朴刀
朴恩惠	朴恩惠
朴凤柱	朴鳳柱
朴父	朴父
朴吉渊	朴吉淵
朴槿惠	朴槿惠
朴京琳	朴京琳
朴璐美	朴璐美
朴茂	朴茂
朴诗妍	朴詩妍
朴世莉	朴世莉
朴树	朴樹
朴泰桓	朴泰桓
朴硝	朴硝
朴新阳	朴新陽
朴宣英	朴宣英
朴永训	朴永訓
朴仔树	朴仔樹
朴赞浩	朴贊浩
朴真熙	朴真熙
朴正恩	朴正恩
朴正熙	朴正熙
朴正祥	朴正祥
朴志胤	朴志胤
朴智星	朴智星
朴忠	朴忠
朴周永	朴周永
朴资茅斯	朴資茅斯
朴子	朴子
埔里	埔里
普勒托利亚	普勒托利亞
普里	普里
普利艾托	普利艾托
七里	七裏
七里河	七里河
七里香	七里香
七娘	七娘
七娘妈	七孃媽
七坛	七罈
七弦	七絃
七扎	七紮
七只	七隻
七周	七週
凄沧	淒滄
凄寒	淒寒
凄冷	淒冷
凄厉	淒厲
凄凉	淒涼
凄雨	淒雨
戚里	戚里
戚戚	慼慼
戚墅堰	慼墅堰
欺蒙	欺矇
齐后破环	齊后破環
齐王舍牛	齊王捨牛
其次	其次
其次辟地	其次辟地
奇杯	奇盃
奇迹	奇蹟
奇里安	奇里安
奇台	奇台
歧化松雪	歧化鬆雪
棋布	棋佈
棋罗星布	棋羅星佈
岂惮温风入	豈憚溫風入
启发	啓發
启发式敎学法	啓發式教學法
起哄	起鬨
起扑杆	起撲桿
气冲	氣衝
气冲斗牛	氣衝斗牛
气冲牛斗	氣衝牛斗
气克斗牛	氣克斗牛
气若游丝	氣若游絲
气色杳在寒山中	氣色杳在寒山中
气势	氣勢
气势熏灼	氣勢熏灼
气吞牛斗	氣吞牛斗
气扬采飞	氣揚采飛
气一冲	氣一衝
弃舍	棄捨
碛卤	磧鹵
恰才	恰纔
千层面	千層麪
千回百折	千迴百折
千回百转	千迴百轉
千钧	千鈞
千钧一发	千鈞一髮
千里	千里
千仞忽弹珠	千仞忽彈珠
千山暮钟发	千山暮鍾發
千载一日	千載一日
千扎	千紮
千只	千隻
迁思回虑	遷思迴慮
牵系	牽繫
牵一发	牽一髮
铅制	鉛製
悭吝	慳吝
悭吝苦克	慳吝苦剋
谦冲	謙沖
签报	簽報
签唱	簽唱
签呈	簽呈
签出	簽出
签单	簽單
签到	簽到
签得	簽得
签订	簽訂
签定	簽定
签赌	簽賭
签发	簽發
签过	簽過
签好	簽好
签结	簽結
签了	簽了
签名	簽名
签派室	簽派室
签入	簽入
签上	簽上
签收	簽收
签书会	簽書會
签署	簽署
签退	簽退
签妥	簽妥
签完	簽完
签爲	簽爲
签下	簽下
签些	簽些
签写	簽寫
签押	簽押
签印	簽印
签有	簽有
签约	簽約
签在	簽在
签章	簽章
签帐	簽帳
签着	簽着
签证	簽證
签証	簽証
签注	簽註
签字	簽字
前车	前車
前车复后车戒	前車覆後車戒
前车之复	前車之覆
前登寒山重	前登寒山重
前仆后继	前仆後繼
前仆后起	前仆後起
钱谷	錢穀
乾清宫	乾清宫
乾象历	乾象曆
潜水	潛水
潜水钟	潛水鐘
潜游	潛游
枪杆	槍桿
枪托	槍托
腔镜使用套扎线	腔鏡使用套扎線
强积金	強積金
强奸	強姦
强投松	強投松
强咽	強嚥
硗确	磽确
敲钟	敲鐘
乔松	喬松
荞麦	蕎麥
荞麦面	蕎麥麪
荞面	蕎麪
桥梁	橋樑
巧历	巧曆
窃闻天子已传位	竊聞天子已傳位
窃占	竊占
窃钟掩耳	竊鐘掩耳
朅来已复去	朅來已復去
侵并	侵併
侵入	侵入
侵入岩	侵入岩
亲娘	親孃
亲幸	親倖
亲征	親征
秦女卷衣	秦女卷衣
秦少游	秦少游
琴断朱弦	琴斷朱絃
琴杆	琴桿
琴弦	琴絃
琴钟	琴鐘
禽巢闭画梁	禽巢閉畫梁
噙齿戴发	噙齒戴髮
青翠有松筠	青翠有鬆筠
青帘	青帘
青苹	青苹
青山	青山
青山一发	青山一髮
青松	青松
轻扣	輕釦
氢卤酸	氫鹵酸
倾复	傾復
倾复重器	傾覆重器
倾斜管	傾斜管
清査不当党产	清查不當黨產
清晨	清晨
清晨杯	清晨盃
清杆运动	清桿運動
清台	清檯
清远县	清遠縣
情采	情采
情系	情繫
情欲	情慾
顷曾策匹马	頃曾策匹馬
庆吊	慶弔
庆历	慶曆
磬钟	磬鐘
穷发	窮髮
穷里	窮里
邱富郁	邱富郁
邱郁婷	邱郁婷
秋不干	秋不乾
秋发	秋髮
秋风桂花发	秋風桂花發
秋桂白花发	秋桂白花發
秋气何高清	秋氣何高清
秋千	鞦韆
秋征	秋征
囚系	囚繫
求知	求知
求知欲	求知慾
虬须	虯鬚
球后	球后
球台	球檯
巯基苯并恶唑	巰基苯並惡唑
屈指数别日	屈指數別日
趋吉避凶	趨吉避凶
曲车	麴車
曲尘	麴塵
曲道	曲道
曲道士	麴道士
曲酒	麴酒
曲卷	曲捲
曲菌	麴菌
曲霉	麴黴
曲蘖	麴櫱
曲钱	麴錢
曲生	麴生
曲松	曲松
曲秀才	麴秀才
曲院	麴院
取舍	取捨
去时无一物	去時無一物
圈扣	圈釦
圈梁	圈樑
权力	權力
权力欲	權力慾
权欲熏心	權慾薰心
全彩	全綵
全斗焕	全斗煥
全干	全乾
诠注	詮註
痊愈	痊癒
鬈发	鬈髮
犬只	犬隻
却才	卻纔
确瘠	确瘠
确系	確係
阙里	闕里
裙摆	裙襬
群多普利	羣多普利
群后	羣后
群谋咸同	羣謀咸同
群辟	羣辟
群蚁附膻	羣蟻附羶
然身死才数月耳	然身死纔數月耳
髯胡	髯鬍
染发	染髮
染干	染干
绕梁	繞樑
热病淖津便不通	熱病淖津便不通
人参	人蔘
人类生态环境	人類生態環境
人物	人物
人物志	人物誌
人欲	人慾
人云	人云
人云亦云	人云亦云
仁杰	仁杰
忍饥受饿	忍饑受餓
忍饥受渴	忍饑受渴
认制修	認製修
日本	日本
日本国	日本國
日本国志	日本國誌
日本制	日本製
日复一日	日復一日
日干	日干
日旰不食	日旰不食
日进斗金	日進斗金
日历	日曆
日甚一日	日甚一日
日慎一日	日慎一日
日昃不食	日昃不食
日志	日誌
日制	日製
荣登后座	榮登后座
溶精于素	溶精於素
溶岩	溶岩
熔毁	熔燬
熔炼	熔鍊
熔岩	熔岩
镕岩	鎔岩
揉面	揉麪
鞣制	鞣製
肉干	肉乾
肉羹面	肉羹麪
肉丝	肉絲
肉丝面	肉絲麪
肉欲	肉慾
如干	如干
如何溆花发	如何漵花發
如荷丘山重	如荷丘山重
如今抛掷上街里	如今拋擲上街裏
如蚁附膻	如蟻附羶
如坐针毡	如坐鍼氈
茹志鹃	茹誌鵑
儒略改革历	儒略改革曆
儒略历	儒略曆
乳娘	乳孃
辱游	辱游
入托	入托
阮咸	阮咸
軟肥皂	软肥皂
瑞郎方面	瑞郎方麪
瑞签	瑞簽
瑞士	瑞士
瑞士卷	瑞士捲
润发	潤髮
若干	若干
弱智	弱智
弱智赖于涵	弱智賴于涵
撒布	撒佈
萨巴克希斯	薩巴克希斯
萨巴托	薩巴托
萨克拉希斯	薩克拉希斯
萨里	薩里
萨托斯	薩託斯
腮斗	腮斗
腮托	腮托
赛里木湖	賽里木湖
三复	三複
三里	三裏
三里河	三里河
三里屯	三里屯
三邻四舍	三鄰四舍
三沐三熏	三沐三薰
三娘教子	三孃教子
三辟	三辟
三秋方一日	三秋方一日
三声画角咽不通	三聲畫角咽不通
三尸	三尸
三天接画梁	三天接畫梁
三统历	三統曆
三瓦四舍	三瓦四舍
三五谁能征	三五誰能徵
三鲜砂锅	三鮮砂鍋
三弦	三絃
三衅三浴	三釁三浴
三熏三沐	三熏三沐
三叶松	三葉松
三浴三熏	三浴三熏
三元	三元
三元里	三元里
三扎	三紮
三征七辟	三徵七辟
三只	三隻
三周	三週
散布	散佈
桑德威奇	桑德威奇
桑干	桑乾
桑托里尼岛	桑托里尼島
桑托荣	桑托榮
桑托斯	桑托斯
丧荡游魂	喪蕩游魂
丧钟	喪鐘
色欲	色慾
铯钟	銫鐘
沙参	沙蔘
沙坑	沙坑
沙坑杆	沙坑桿
沙里	沙裏
沙里夫	沙里夫
沙仑	沙崙
沙普利	沙普利
沙岩	沙岩
砂锅面	砂鍋麪
砂岩	砂岩
莎伊斯	莎伊斯
傻里傻气	傻里傻氣
晒干	曬乾
晒谷	曬穀
晒烟	曬菸
山崩	山崩
山崩钟应	山崩鐘應
山店橘花发	山店橘花發
山斗	山斗
山鸡腿	山雞腿
山里	山裏
山里站	山里站
山梁	山樑
山岩	山岩
山羊	山羊
山羊胡	山羊鬍
山羊须	山羊鬚
山仔	山仔
山仔后	山仔后
山中无历日	山中無曆日
山重水复	山重水複
珊希斯	珊希斯
膻中	膻中
鳝鱼	鱔魚
鳝鱼面	鱔魚麪
商历	商曆
赏赞	賞讚
上不通	上不通
上车仔	上車仔
上冲	上衝
上冲下洗	上沖下洗
上复	上覆
上海嘉柏	上海嘉柏
上合	上合
上合屋	上閤屋
上课	上課
上课钟	上課鐘
上栗	上慄
上栗县	上栗縣
上链	上鍊
上梁	上樑
上梁不正下梁歪	上樑不正下樑歪
上头日日风复雨	上頭日日風復雨
上阳宫树千花发	上陽宮樹千花發
上野树里	上野樹里
上游	上游
上周	上週
尚味一号	尚味一號
烧干	燒乾
烧毁	燒燬
烧制	燒製
筲斗	筲斗
韶山	韶山
韶山冲	韶山沖
邵廷采	邵廷采
舌干唇焦	舌乾脣焦
舌干脣焦	舌乾脣焦
舌一卷	舌一捲
蛇发女妖	蛇髮女妖
蛇绿混杂岩	蛇綠混雜岩
蛇绿岩	蛇綠岩
蛇皮松	蛇皮松
蛇纹岩	蛇紋岩
舍安就危	捨安就危
舍本	捨本
舍不得	捨不得
舍车保帅	捨車保帥
舍出	捨出
舍得	捨得
舍短从长	捨短從長
舍短录长	捨短錄長
舍短取长	捨短取長
舍短用长	捨短用長
舍堕	捨墮
舍己	捨己
舍近即远	捨近即遠
舍近谋远	捨近謀遠
舍近求远	捨近求遠
舍近务远	捨近務遠
舍旧迎新	捨舊迎新
舍命	捨命
舍弃	捨棄
舍去	捨去
舍身	捨身
舍生	捨生
舍实	捨實
舍死忘生	捨死忘生
舍我复谁	捨我復誰
舍我其谁	捨我其誰
舍下	舍下
舍下你	捨下你
舍下他	捨下他
舍下她	捨下她
舍下我	捨下我
舍正从邪	捨正從邪
设言托意	設言托意
射雕	射鵰
射复	射覆
射干	射干
摄制	攝製
麝香回阳	麝香回陽
申复	申覆
身敎重于言敎	身教重於言教
身上艺能无不通	身上藝能無不通
身系囹圄	身繫囹圄
深成岩	深成岩
深萝月不通	深蘿月不通
深山	深山
深山何处钟	深山何處鐘
什锦	什錦
什锦面	什錦麪
神采	神采
神雕	神鵰
神飞气扬	神飛氣揚
神龟出负图	神龜出負圖
神魂	神魂
神魂荡飏	神魂盪颺
神迹	神蹟
神曲	神曲
神曲茶	神麴茶
神圣	神聖
神圣周	神聖週
神摇魂荡	神搖魂盪
沈海	瀋海
沈河	瀋河
沈积	沈積
沈积岩	沈積岩
沈吉线	瀋吉線
沈山线	瀋山線
沈水	瀋水
沈阳	瀋陽
沈州	瀋州
审核	審覈
婶娘	嬸孃
肾脏	腎臟
升斗	升斗
升汞	昇汞
升华	昇華
升平	昇平
升天	昇天
升仙	昇仙
升阳	昇陽
生旦淨末丑	生旦淨末丑
生栋复屋	生棟覆屋
生发	生髮
生姜	生薑
生力	生力
生力面	生力麪
生态	生態
生态环境游	生態環境游
生田斗	生田斗
生物	生物
生物钟	生物鐘
绳扣	繩釦
省欲去奢	省慾去奢
圣杯	聖盃
圣德膺三统	聖德膺三統
圣哈辛托	聖哈辛托
圣赫勒拿和阿森松	聖赫勒拿和阿森鬆
圣迹	聖蹟
圣酒黄花发	聖酒黃花發
圣帕	聖帕
圣帕强台	聖帕強颱
圣神降临周	聖神降臨週
圣修伯里	聖修伯里
圣言在推诚	聖言在推誠
胜迹	勝蹟
胜键	胜鍵
胜肽	胜肽
盛价	盛价
盛赞	盛讚
尸臣	尸臣
尸谏	尸諫
尸解	尸解
尸鸠	尸鳩
尸居龙见	尸居龍見
尸居余气	尸居餘氣
尸利	尸利
尸禄	尸祿
尸陀林	尸陀林
尸位	尸位
尸饔	尸饔
尸祝	尸祝
失之毫厘	失之毫釐
失之毫厘谬以千里	失之毫厘謬以千里
师娘	師孃
师生	師生
师生杯	師生盃
师云而云	師云而云
诗云	詩云
诗赞	詩讚
诗钟	詩鐘
施佳升	施佳昇
施仁布恩	施仁佈恩
施仁布泽	施仁佈澤
施舍	施捨
施粥舍饭	施粥捨飯
湿地	溼地
湿地松	溼地松
詩云	詩云
十不当一	十不當一
十分	十分
十分干	十分乾
十干	十干
十里	十里
十年粉蠹生画梁	十年粉蠹生畫梁
十扎	十紮
十只	十隻
十周	十週
石拐	石柺
石灰	石灰
石灰岩	石灰岩
石几	石几
石枯松老	石枯松老
石梁	石樑
石路寒花发	石路寒花發
石松	石松
石屋	石屋
石屋制果	石屋製果
石英	石英
石英表	石英錶
石英岩	石英岩
石英钟	石英鐘
石钟乳	石鐘乳
时过忆松筠	時過憶鬆筠
时尚	時尚
时尚周	時尚週
时宪历	時憲曆
时钟	時鐘
时装	時裝
时装周	時裝週
拾沈	拾瀋
食面	食麪
食野之苹	食野之苹
食欲	食慾
史査克	史查克
史迹	史蹟
史托姆	史托姆
史托瑟	史托瑟
史托苏儿	史托蘇兒
史托腾柏格	史托騰柏格
史托威	史托威
史游	史游
使余刀兮剪余发	使餘刀兮剪餘發
使余力兮翦余发	使餘力兮翦餘發
始见才吞亦气吞	始見才吞亦氣吞
始来兹山中	始來茲山中
士干皮	士幹皮
示复	示覆
世彩堂	世綵堂
世纪	世紀
世纪钟	世紀鐘
世界	世界
世界杯	世界盃
市长	市長
市长杯	市長盃
事迹	事蹟
事可干	事可幹
事情	事情
事情干脆	事情干脆
事情可干	事情可幹
饰扣	飾釦
试验	試驗
试验台	試驗檯
试制	試製
拭干	拭乾
是只	是隻
适当的	適當的
視如寇仇	視如寇讎
释压面	釋壓面
嗜酸	嗜酸
嗜酸乳干菌	嗜酸乳干菌
嗜欲	嗜慾
收获	收穫
手表	手錶
手工	手工
手工台	手工檯
手链	手鍊
手面	手面
手面赚吃	手面賺吃
手术	手術
手术台	手術檯
手酸	手痠
手一卷	手一捲
手折	手摺
手制	手製
手冢治虫	手冢治虫
守财奴卡波尔	守財奴卡波爾
守御	守禦
首都	首都
首都杯	首都盃
首只	首隻
寿面	壽麪
受命于天	受命於天
受他驱遣还复去	受他驅遣還復去
兽奸	獸姦
兽欲	獸慾
瘦身一号	瘦身一號
书台	書檯
殊域周咨录	殊域周咨錄
梳发	梳髮
梳妆	梳妝
梳妆台	梳妝檯
淑郁	淑郁
舒卷	舒捲
输征	輸征
蜀道蔼松筠	蜀道藹鬆筠
鼠曲草	鼠麴草
术赤	朮赤
束发	束髮
束修	束脩
树梁	樹樑
恕乏价催	恕乏价催
数个	數箇
数与虏确	數與虜确
数周	數週
数字	數字
数字高清	數字高清
数字钟	數字鐘
数罪并罚	數罪併罰
甩发	甩髮
双雕	雙鵰
双拐	雙柺
双后前兵开局	雙后前兵開局
双胜类	雙胜類
双特松	雙特鬆
双燕双飞绕画梁	雙燕雙飛繞畫梁
双折	雙摺
双周	雙週
霜纹斗蓬	霜紋鬥蓬
谁言一朝复一日	誰言一朝復一日
水表	水錶
水才干	水纔乾
水成岩	水成岩
水斗	水斗
水干	水乾
水谷	水谷
水谷之海	水穀之海
水管	水管
水管面	水管麪
水里	水裏
水里乡	水里鄉
水里鄉	水里鄉
水气朦胧满画梁	水氣朦朧滿畫梁
水蛇皮	水蛇皮
水松皮	水鬆皮
水楔不通	水楔不通
水泄不通	水泄不通
水洩不通	水洩不通
水一冲	水一衝
水已干	水已乾
睡眠	睡眠
睡眠欲	睡眠慾
顺德	順德
顺德者吉逆天者凶	順德者吉逆天者凶
顺钟向	順鐘向
顺朱儿	順硃兒
舜海词波发	舜海詞波發
说法动海岳	說法動海嶽
说岳	說岳
丝恩发怨	絲恩髮怨
丝发	絲髮
丝杆	絲桿
丝管荷风入	絲管荷風入
丝托索	絲托索
丝弦	絲絃
私欲	私慾
斯伯丁杯	斯伯丁盃
斯迪波尔	斯迪波爾
斯迪里	斯迪里
斯干	斯干
斯里	斯里
斯里査潘	斯里查潘
斯普林瓦尔	斯普林瓦爾
斯人不重见	斯人不重見
斯托	斯托
斯瓦希里	斯瓦希里
死面	死麪
死伤	死傷
死伤相借	死傷相藉
四分	四分
四分历	四分曆
四国靡不通	四國靡不通
四海	四海
四海皆准	四海皆准
四户八窗明	四戶八窗明
四里	四里
四面	四面
四面钟	四面鐘
四舍六入	四捨六入
四舍五入	四捨五入
四凶	四凶
四扎	四紮
四只	四隻
寺钟	寺鐘
饲喂	飼餵
松巴哇	松巴哇
松柏	松柏
松北	松北
松本	松本
松材线虫	松材線蟲
松大辅	松大輔
松风	松風
松冈	松岡
松高	鬆高
松高路	松高路
松果	松果
松鹤	松鶴
松花	松花
松化石	松化石
松篁交翠	松篁交翠
松鸡	松雞
松江	松江
松胶	松膠
松焦油	松焦油
松节	鬆節
松节油	松節油
松井秀	松井秀
松菌	松菌
松筠之操	松筠之操
松筠之节	松筠之節
松科	松科
松口	鬆口
松口蘑	松口蘑
松扣	鬆釦
松类	松類
松辽平原	松遼平原
松林	松林
松岭	松嶺
松隆子	松隆子
松露	松露
松萝	松蘿
松毛	松毛
松茂竹苞	鬆茂竹苞
松煤	松煤
松明	松明
松蘑	松蘑
松漠	松漠
松木	松木
松潘	松潘
松皮癣	松皮癬
松浦	松浦
松乔	松喬
松青	松青
松丘	松丘
松球	松球
松毬	松毬
松瓤	松瓤
松仁	松仁
松茸	松茸
松蕊	松蕊
松山	松山
松狮犬	松獅犬
松石	松石
松鼠	松鼠
松树	松樹
松涛	松濤
松桃	鬆桃
松桃苗族自治县	松桃苗族自治縣
松桃县	松桃縣
松田	松田
松尾	鬆尾
松尾芭蕉	松尾芭蕉
松纹	松紋
松溪	松溪
松下	松下
松香	松香
松形鹤骨	鬆形鶴骨
松雪泰子	松雪泰子
松蕈	松蕈
松鸦	松鴉
松烟	松煙
松阳	松陽
松叶	松葉
松油	松油
松鱼	松魚
松原	松原
松赞干布	松贊干布
松藻虫	松藻蟲
松针	松針
松枝	松枝
松脂	松脂
松指部	松指部
松智路	松智路
松竹	松竹
松子	松子
駷跃惊矫浮云翻	駷躍驚矯浮雲翻
送报	送報
送报夫	送報伕
诵念	誦唸
颂系	頌繫
颂赞	頌讚
搜藏	蒐藏
搜査证	搜查證
搜购	蒐購
搜集	蒐集
搜括	蒐括
搜罗	蒐羅
搜证	蒐證
溲面	溲麪
苏杯	蘇盃
苏格兰	蘇格蘭
苏格兰折耳猫	蘇格蘭摺耳貓
苏哈托	蘇哈托
苏家屯	甦家屯
苏昆	蘇崑
苏里	蘇里
苏仙	蘇仙
苏仙区	甦仙區
苏醒	甦醒
苏扬托	蘇揚托
酥签	酥簽
夙昔尝许人	夙昔嘗許人
素发	素髮
素借	素藉
塑胶	塑膠
塑胶制	塑膠製
溯游	溯游
酸懒	痠懶
酸麻	痠麻
酸软	痠軟
酸疼	痠疼
酸痛	痠痛
蒜发	蒜髮
蒜苔	蒜薹
算发	算髮
算历	算曆
虽复能复	雖覆能復
岁凶	歲凶
岁聿云暮	歲聿云暮
脺脏	脺臟
碎发	碎髮
碎屑	碎屑
碎屑岩	碎屑岩
穗裳	繐裳
穗帏飘井干	繐幃飄井幹
穗帷	繐帷
穗帐	繐帳
孙杰	孫杰
笋干	筍乾
缩影	縮影
缩影微卷	縮影微捲
所布的	所佈的
所布之	所佈之
所系	所繫
所云	所云
索尔	索爾
索尔兹伯里	索爾茲伯裏
索尔兹伯里平原	索爾茲伯里平原
索尔兹伯里石环	索爾茲伯里石環
索里士	索里士
索马里	索馬里
索馬里	索馬里
索面	索麪
索托	索托
锁扣	鎖釦
他皆缓别日	他皆緩別日
他钟	他鐘
塔克	塔克
塔克拉马干	塔克拉馬干
塔克拉玛干	塔克拉瑪干
塔里班	塔里班
塔里木	塔里木
塔里契亚努	塔里契亞努
塔什干	塔什干
塔什库尔干	塔什庫爾幹
塔什库尔干塔吉克	塔什庫爾幹塔吉克
塔什库尔干塔吉克自治县	塔什庫爾干塔吉克自治縣
塔什库尔干乡	塔什庫爾干鄉
塔什库尔干自治县	塔什庫爾干自治縣
塔希斯	塔希斯
塔钟	塔鐘
胎发	胎髮
台安	檯安
台笔	檯筆
台布	檯布
台秤	檯秤
台灯	檯燈
台凳	檯凳
台风	颱風
台鉴	臺鑒
台历	檯曆
台面	檯面
台盘	檯盤
台球	檯球
台山	台山
台扇	檯扇
台湾	臺灣
台湾敎育学院	臺灣教育學院
台湾台	臺灣台
台制	臺製
台中	臺中
台中敎育大学	臺中教育大學
台钟	檯鐘
台州	台州
骀借	駘藉
太冲	太沖
太初历	太初曆
太傅里	太傅裏
太干	太乾
太后	太后
太麻里	太麻里
太阳	太陽
太阳黑子	太陽黑子
太阳黑子周	太陽黑子週
泰斗	泰斗
泰希斯	泰希斯
贪欲	貪慾
坛白干	罈白干
坛陈年	罈陳年
坛高粱	罈高粱
坛好酒	罈好酒
坛騞	罈騞
坛佳酿	罈佳釀
坛老酒	罈老酒
坛美酒	罈美酒
坛女儿红	罈女兒紅
坛烧刀子	罈燒刀子
坛燒刀子	罈燒刀子
坛坛罐罐	罈罈罐罐
坛子	罈子
潭祉叶吉	潭祉叶吉
叹服	歎服
叹号	歎號
叹绝	歎絕
叹赏	歎賞
叹为	嘆爲
叹为观止	歎爲觀止
叹羡	歎羨
探知	探知
探知欲	探知慾
碳酸	碳酸
碳酸岩	碳酸岩
歎吁	歎吁
汤面	湯麪
汤团	湯糰
汤下	湯下
汤下面	湯下麪
糖醋	糖醋
糖醋里脊	糖醋里脊
烫次发	燙次髮
烫发	燙髮
烫个	燙個
烫个发	燙個髮
烫面	燙麪
烫完发	燙完髮
烫一次发	燙一次髮
烫一个发	燙一個髮
桃花鸡腿	桃花雞腿
陶拉祖	陶拉祖
陶潜县里看花发	陶潛縣裏看花發
陶制	陶製
特里	特里
特伦希斯	特倫希斯
特内里费	特內里費
特松加	特松加
特制	特製
特准	特准
腾升	騰昇
藤制	藤製
提梁	提樑
提制	提製
提子	提子
提子干	提子乾
题签	題簽
剃发	剃髮
剃胡	剃鬍
剃须	剃鬚
天冬	天冬
天冬酰胺	天冬醯胺
天翻地复	天翻地覆
天复	天覆
天干	天干
天干物燥	天乾物燥
天后	天后
天纪未可干	天紀未可幹
天克地冲	天剋地衝
天历	天曆
天台	天台
天文	天文
天文学	天文學
天文学钟	天文學鐘
天文钟	天文鐘
天香留凤尾	天香留鳳尾
天心	天心
天心岩	天心岩
天要落雨娘要嫁人	天要落雨孃要嫁人
天要下雨娘要嫁人	天要下雨孃要嫁人
天字第一号	天字第一號
田谷	田穀
甜面醬	甜麪醬
甜水	甜水
甜水面	甜水麪
捵面	捵麪
挑大梁	挑大樑
挑了	挑了
挑了只	挑了隻
条几	條几
调表	調錶
调査团	調查團
调弦	調絃
调制	調製
跳表	跳錶
跳梁	跳梁
跳梁猖獗之小丑	跳樑猖獗之小醜
跳梁小丑	跳樑小醜
跳只舞	跳隻舞
铁板	鐵板
铁板面	鐵板麪
铁杆	鐵桿
铁拐	鐵柺
铁扣	鐵釦
铁托	鐵托
铁制	鐵製
铁钟	鐵鐘
听弦	聽絃
庭前时有东风入	庭前時有東風入
庭树千花发	庭樹千花發
停制	停製
通布图	通佈圖
通草炖猪脚	通草燉豬腳
通奸	通姦
通历	通曆
通心面	通心麪
同吃	同吃
同人	同人
同人志	同人誌
同休共戚	同休共慼
铜斗儿	銅斗兒
铜扣	銅釦
铜制	銅製
铜钟	銅鐘
瞳蒙	瞳矇
偷尝禁果	偷嚐禁果
偷梁换柱	偷樑換柱
头发	頭髮
头发胡子一把抓	頭髮鬍子一把抓
头花	頭花
头花发	頭花髮
头巾	頭巾
头巾吊在水里	頭巾弔在水裏
投托	投托
透明窗	透明窗
秃发	禿髮
秃妃之发	禿妃之髮
图书	圖書
图书馆	圖書館
图书馆周	圖書館週
徒看众花发	徒看衆花發
涂長望	涂長望
涂尔干	涂爾干
涂逢年	涂逢年
涂鸿钦	涂鴻欽
涂鴻欽	涂鴻欽
涂惠元	涂惠元
涂惠源	涂惠源
涂浆台	塗漿檯
涂谨申	涂謹申
涂謹申	涂謹申
涂居贤	涂居賢
涂坤	涂坤
涂美伦	涂美倫
涂敏恒	涂敏恆
涂敏恆	涂敏恆
涂善妮	涂善妮
涂绍煃	涂紹煃
涂天相	涂天相
涂文生	涂文生
涂醒哲	涂醒哲
涂姓	涂姓
涂序瑄	涂序瑄
涂永辉	涂永輝
涂羽卿	涂羽卿
涂月	涂月
涂泽	塗澤
涂泽民	涂澤民
涂澤民	涂澤民
涂长望	涂長望
涂壮勋	涂壯勳
涂壯勳	涂壯勳
土谷祠	土穀祠
土托鱼	土托魚
土制	土製
团粉	糰粉
团伙	團伙
团子	糰子
团𪢮	團圞
抟空捕影	摶空捕影
推陈布新	推陳佈新
推诚布公	推誠佈公
推诚布信	推誠佈信
推辇归里	推輦歸里
推托	推託
推托之词	推托之詞
推挽	推輓
推弦	推絃
腿酸	腿痠
吞并	吞併
吞咽	吞嚥
屯扎	屯紮
托杯	托杯
托比麦奎尔	托比麥奎爾
托比亚斯	托比亞斯
托钵	託鉢
托钵人	托鉢人
托钵僧	托鉢僧
托钵修会	托鉢修會
托鉢	托鉢
托出	托出
托胆	托膽
托登汉队	托登漢隊
托地	托地
托蒂	托蒂
托儿	托兒
托尔	托爾
托夫	托夫
托福	託福
托福考	托福考
托荤咸食	托葷鹹食
托架	托架
托克	托克
托克托	托克托
托拉	托拉
托辣斯	托辣斯
托莱多	托萊多
托赖	托賴
托老院	托老院
托老中心	托老中心
托勒	托勒
托里	托裏
托利	託利
托利党人	托利黨人
托利米尔	托利米爾
托领	托領
托罗斯山	托羅斯山
托洛茨基	托洛茨基
托洛斯基	托洛斯基
托马	托馬
托米	托米
托墨	托墨
托木尔	托木爾
托盘	托盤
托起	托起
托瑞赛	托瑞賽
托瑞丝	托瑞絲
托腮	托腮
托塞洛	托塞洛
托色	托色
托实	托實
托熟	托熟
托斯卡	托斯卡
托塔天王	托塔天王
托胎	托胎
托特	托特
托维	托維
托叶	托葉
托幼	托幼
托育	托育
托运	託運
托运行李	托運行李
托住	托住
托子	托子
托足	托足
拖斗	拖斗
脱发	脫髮
脱谷机	脫穀機
坨里	坨里
跎纤	跎縴
唾面	唾面
唾面自干	唾面自乾
唾沫	唾沫
唾沫直咽	唾沫直嚥
洼徐家	窪徐家
瓦尔基里	瓦爾基里
瓦莱里	瓦萊裏
瓦里	瓦里
瓦松	瓦松
外强中干	外強中乾
外烟	外菸
外欲	外慾
外御其侮	外禦其侮
外制	外製
弯管	彎管
弯管面	彎管麪
完全	完全
完全愈复	完全癒復
玩具公仔	玩具公仔
顽卤	頑鹵
顽筑舞笈	頑筑舞笈
挽词	輓詞
挽詞	輓詞
挽额	輓額
挽夫	輓夫
挽歌	輓歌
挽联	輓聯
挽聯	輓聯
挽曲	輓曲
挽诗	輓詩
挽詩	輓詩
晚钟	晚鐘
绾发	綰髮
碗面	碗麪
万里	萬里
万里长征	萬里長征
万历	萬曆
万年	萬年
万年历表	萬年曆錶
万牛回首丘山重	萬牛回首丘山重
万旗	万旗
万人不可干	萬人不可幹
万俟	万俟
万坛	萬罈
万扎	萬紮
万只	萬隻
腕表	腕錶
王干发	王乾發
王侯	王侯
王侯后	王侯后
王后	王后
王每中一物	王每中一物
王熙松	王熙松
王于真	王于真
王正杰	王正杰
王子	王子
王子面	王子麪
网御	網禦
网志	網誌
往日	往日
往日無仇	往日無讎
忘生舍死	忘生捨死
望风捕影	望風捕影
望后石	望后石
危地马拉	危地馬拉
威奇托	威奇托
威远县	威遠縣
偎干	偎乾
煨干	煨乾
韦后	韋后
为中台	爲中颱
唯闻旅思将花发	唯聞旅思將花發
维斗	維斗
维康采	維康採
维克	維克
维克托	維克托
维系	維繫
伟晶岩	偉晶岩
苇苕系巢	葦苕繫巢
苇席	葦蓆
尾长窣地如红丝	尾長窣地如紅絲
尾注	尾註
委树寒花发	委樹寒花發
卫星	衛星
卫星钟	衛星鐘
未干	未乾
位错卷线	位錯卷線
胃脏	胃臟
喂饱	餵飽
喂哺	餵哺
喂动物	餵動物
喂鹅	餵鵝
喂饭	餵飯
喂给	餵給
喂过	餵過
喂鸡	餵雞
喂了	餵了
喂驴	餵驢
喂马	餵馬
喂母乳	餵母乳
喂奶	餵奶
喂你	餵你
喂乳	餵乳
喂食	餵食
喂它	餵它
喂我	餵我
喂鸭	餵鴨
喂羊	餵羊
喂养	餵養
喂鱼	餵魚
喂猪	餵豬
慰借	慰藉
魏郁奇	魏郁奇
温诺希斯	溫諾希斯
文采	文采
文采郁郁	文采郁郁
文丑	文丑
文锦复阱	文錦覆阱
文理不通	文理不通
文斯范恩	文斯范恩
文物驱三统	文物驅三統
文章扫地无	文章掃地無
炆面	炆麪
稳吃三注	穩吃三注
稳扎	穩紮
问卷	問卷
问卷大调査	問卷大調查
问卷调査	問卷調查
问事爱知天宝里	問事愛知天寶裏
翁干晃	翁乾晃
翁根艾里	翁根艾裏
翁郁容	翁郁容
窝里	窩裏
窝里窝囊	窩里窩囊
蜗杆	蝸桿
我念前人譬葑菲	我念前人譬葑菲
我系	我係
沃依采克	沃依采克
卧薪尝胆	臥薪嚐膽
握发	握髮
握风捕影	握風捕影
乌东査克	烏東查克
乌发	烏髮
乌干达	烏干達
乌狗吃食白狗当灾	烏狗吃食白狗當災
乌兰	烏蘭
乌兰巴托	烏蘭巴托
乌里	烏里
乌龙	烏龍
乌龙面	烏龍麪
乌洛托品	烏洛托品
乌蛇皮	烏蛇皮
乌松	烏松
乌托邦	烏托邦
污蔑	污衊
巫咸	巫咸
诬蔑	誣衊
屋梁	屋樑
无干	無干
无价	無價
无价事	無价事
无精打采	無精打采
无厘头	無厘頭
无梁	無樑
无梁斗	無樑斗
无所不通	無所不通
无欲	無慾
吴采璋	吳采璋
吴皓升	吳皓昇
吴里克	吳里克
吴荣杰	吳榮杰
吴育升	吳育昇
無言不仇	無言不讎
五采	五采
五斗	五斗
五谷	五穀
五行	五行
五行生克	五行生剋
五棵松	五棵松
五里	五里
五辟	五辟
五弦	五絃
五脏	五臟
五扎	五紮
五只	五隻
五周	五週
伍采克	伍采克
武丑	武丑
武大	武大
武大郎吃毒药	武大郎吃毒藥
武后	武后
武里省	武里省
武松	武松
舞后	舞后
舞水端里	舞水端里
兀术	兀朮
勿里洞岛	勿里洞島
物换星移	物換星移
物欲	物慾
西后	西后
西江广复平	西江廣復平
西拉普利	西拉普利
西里	西里
西历	西曆
西利古里	西利古里
西松	西松
西往华山中	西往華山中
西征	西征
西周	西周
西周钟	西周鐘
吸干	吸乾
吸烟	吸菸
希伯来	希伯來
希伯来历	希伯來曆
希拉	希拉
希拉克	希拉剋
希斯仑	希斯崙
矽岩	矽岩
矽质岩	矽質岩
息谷	息穀
晞发	晞髮
欷吁	欷吁
稀里	稀里
稀里哗啦	稀里嘩啦
傒幸	傒倖
锡惠里	錫惠裏
徯幸	徯倖
席卷	席捲
席棚	蓆棚
席志成	席誌成
袭卷	襲捲
洗荡	洗盪
洗发	洗髮
洗发皂	洗髮皂
洗脸	洗臉
洗脸台	洗臉檯
洗手	洗手
洗手台	洗手檯
喜欢	喜歡
喜欢表	喜歡錶
喜欢钟	喜歡鐘
戏彩娱亲	戲綵娛親
系臂	係臂
系臂之宠	繫臂之寵
系泊	繫泊
系船	系船
系船桩	繫船樁
系辞	繫辭
系带	繫帶
系到	繫到
系而不食	繫而不食
系发带	繫髮帶
系风捕景	繫風捕景
系风捕影	繫風捕影
系缚	繫縛
系个	繫個
系裹	繫裹
系好	繫好
系怀	繫懷
系获	係獲
系结	繫結
系紧	繫緊
系颈	繫頸
系颈阙庭	係頸闕庭
系扣	係扣
系裤子	繫褲子
系缆	繫纜
系牢	繫牢
系了	繫了
系累	繫累
系恋	繫戀
系铃解铃	繫鈴解鈴
系铃人	繫鈴人
系留	繫留
系马	繫馬
系命	繫命
系捻儿	繫捻兒
系念	繫念
系囚	繫囚
系上	繫上
系绳	繫繩
系世	繫世
系数	係數
系丝带	繫絲帶
系蹄	係蹄
系条	繫條
系头巾	繫頭巾
系为	係爲
系爲	係爲
系系	繫系
系鞋带	繫鞋帶
系心	繫心
系腰	繫腰
系一番	係一番
系一片	係一片
系一线	繫一線
系一种	係一種
系有	繫有
系于	繫於
系于一发	繫於一髮
系狱	繫獄
系爪	繫爪
系着	繫着
系争	係爭
系指	係指
系趾	繫趾
系踵	係踵
系住	繫住
细不容发	細不容髮
细炼	細鍊
细如发	細如髮
细咽	細嚥
细致	細緻
舄卤	舄鹵
潟卤	潟鹵
虾干	蝦乾
虾须	蝦鬚
侠气	俠氣
侠气干云	俠氣干雲
狎妓	狎妓
狎妓冶游	狎妓冶游
遐瞰靡不通	遐瞰靡不通
下摆	下襬
下采	下采
下课	下課
下课钟	下課鐘
下里	下里
下梁	下樑
下仑路	下崙路
下视众山中	下視衆山中
下微本大者则为关格不通	下微本大者則爲關格不通
下咽	下嚥
下游	下游
下周	下週
夏后氏	夏后氏
夏里夫	夏里夫
夏历	夏曆
夏日山中	夏日山中
夏于乔	夏于喬
夏于喬	夏于喬
仙后	仙后
仙迹	仙蹟
仙台	仙台
仙岩	仙岩
仙掌云重见	仙掌雲重見
先尝	先嚐
先干为敬	先乾爲敬
先签	先簽
先天	先天
先天下之忧而忧	先天下之憂而憂
先天下之忧而忧后天下之乐而乐	先天下之憂而憂后天下之樂而樂
纤夫	縴夫
纤户	縴戶
鲜谷王	鮮穀王
鲜于	鮮于
贤后	賢后
弦动	絃動
弦断	絃斷
弦歌	絃歌
弦乐	絃樂
弦器	絃器
弦琴	絃琴
弦声	絃聲
弦索	絃索
弦线	絃線
弦音	絃音
弦轴	絃軸
咸安	鹹安
咸安区	咸安區
咸池	咸池
咸丰	咸豐
咸和	咸和
咸亨	咸亨
咸镜	咸鏡
咸卤	鹹鹵
咸宁	咸寧
咸认为	咸認爲
咸五登三	咸五登三
咸信	咸信
咸兴	咸興
咸阳	咸陽
咸宜	咸宜
賢后	賢后
显示	顯示
显示表	顯示錶
显示钟	顯示鐘
县志	縣誌
羡叹	羨歎
腺毛鹅不食	腺毛鵝不食
乡里	鄉里
乡愿	鄉愿
相并	相併
相冲	相沖
相干	相干
相奸	相姦
相克	相剋
相里	相里
相思一夜梅花发	相思一夜梅花發
相托	相托
相寻路不通	相尋路不通
香巴拉	香巴拉
香臭谁为中	香臭誰爲中
香斗	香斗
香干	香乾
香港中环	香港中環
香榭里	香榭裏
香榭里大道	香榭里大道
香烟	香菸
香郁	香郁
香皂	香皂
箱扣	箱釦
详注	詳註
响弦	響絃
响钟	響鐘
向导	嚮導
向迩	嚮邇
向晦	嚮晦
向明	嚮明
向慕	嚮慕
向往	嚮往
向应	嚮應
向者	曏者
项链	項鍊
橡斗	橡斗
橡子	橡子
橡子面	橡子麪
逍遥三花发	逍遙三花發
消费	消費
消费欲	消費慾
宵征	宵征
萧参	蕭蔘
萧行范篆	蕭行范篆
萧萧驱匹马	蕭蕭驅匹馬
销毁	銷燬
小便	小便
小便斗	小便斗
小尝	小嚐
小丑	小丑
小丑跳梁	小醜跳樑
小范	小范
小几	小几
小价	小价
小杰	小杰
小栗旬	小栗旬
小树林大街林古里	小樹林大街林古裏
小松	小松
小型	小型
小型钟	小型鐘
小余	小余
小云	小云
小泽征尔	小澤征爾
小只	小隻
小钟	小鐘
校核	校覈
歇斯底里	歇斯底里
邪不干正	邪不干正
邪不可干	邪不可幹
邪辟	邪辟
斜管面	斜管麪
鞋扣	鞋釦
写易晚窗明	寫易晚窗明
写字	寫字
写字台	寫字檯
泄欲	泄慾
械系	械繫
谢福松	謝福松
谢里	謝里
蟹黄	蟹黃
蟹黄鲍鱼面	蟹黃鮑魚麪
蟹肉羹	蟹肉羹
心荡神摇	心蕩神搖
心花怒发	心花怒發
心系	心繫
心细	心細
心细似发	心細似髮
心弦	心絃
心相系	心相繫
心阳不通	心陽不通
心脏	心臟
心脏复苏术	心臟復甦術
辛丑	辛丑
辛光一号	辛光一號
辛辣	辛辣
辛辣面	辛辣麪
辛里希	辛里希
辛勤作窠在画梁	辛勤作窠在畫梁
欣采翰林芳	欣採翰林芳
新艾里	新艾裏
新干	新干
新喀里多尼亚	新喀里多尼亞
新历	新曆
新扎	新紮
信马游缰	信馬游繮
信天游	信天游
信托	信託
信托贸易	信托貿易
衅钟	釁鐘
星辰	星辰
星辰表	星辰錶
星斗	星斗
星回	星迴
星历	星曆
星历表	星曆錶
星罗云布	星羅雲佈
星系风	星系風
星移斗换	星移斗換
星移斗转	星移斗轉
星占学	星占學
刑克	刑剋
刑辟	刑辟
刑于	刑于
形单影只	形單影隻
形孤影只	形孤影隻
形影	形影
形影相吊	形影相弔
型面涂浆	型面塗漿
醒酒微风入	醒酒微風入
兴安鹅不食	興安鵝不食
兴云布雨	興雲佈雨
幸臣	倖臣
幸存	倖存
幸感歌姬	倖感歌姬
幸各对松筠	幸各對鬆筠
幸进	倖進
幸免	倖免
幸幸	倖幸
幸运	幸運
幸运胡	幸運鬍
性泼凶顽	性潑凶頑
性欲	性慾
姓名音信两不通	姓名音信兩不通
姓岳	姓岳
凶德	凶德
凶地	凶地
凶多吉少	凶多吉少
凶服	凶服
凶怪	凶怪
凶耗	凶耗
凶荒	凶荒
凶礼	凶禮
凶门	凶門
凶逆	凶逆
凶年	凶年
凶年饥岁	凶年饑歲
凶气	凶氣
凶日	凶日
凶煞	凶煞
凶身	凶身
凶神	凶神
凶事	凶事
凶竖	凶豎
凶死	凶死
凶肆	凶肆
凶岁	凶歲
凶信	凶信
凶讯	凶訊
凶燄	凶燄
凶宅	凶宅
凶兆	凶兆
凶终隙末	凶終隙末
胸阳不通	胸陽不通
雄斗斗	雄斗斗
休仑湖	休崙湖
休戚	休慼
修胡刀	修鬍刀
修杰楷	修杰楷
修金	脩金
修敬	脩敬
修名	脩名
修脯	脩脯
修润	脩潤
修樾	脩樾
宿松	宿松
秀发	秀髮
秀兰邓波尔	秀蘭鄧波爾
袖扣	袖釦
袖一卷	袖一捲
吁咈	吁咈
吁嗟	吁嗟
吁了	吁了
吁气	吁氣
吁叹	吁嘆
吁吁	吁吁
吁嘘	吁噓
吁俞	吁俞
须发	鬚髮
须根	鬚根
须后	須後
须后水	鬚後水
须胡	鬚鬍
须鲸	鬚鯨
须毛	鬚毛
须眉	鬚眉
须弥山	須彌山
须髯	鬚髯
须鲨	鬚鯊
须生	鬚生
须须	鬚鬚
须子	鬚子
虚白无不通	虛白無不通
虚冲	虛沖
虚空男爵加拉希斯	虛空男爵加拉希斯
墟里	墟里
徐汇	徐匯
徐汇区	徐彙區
徐家汇	徐家彙
徐余伟	徐余偉
徐赞升	徐讚昇
许人丰	許人丰
许圣杰	許聖杰
许愿	許願
许愿起经	許愿起經
旭日	旭日
旭日初升	旭日初昇
恤典	卹典
恤荒	卹荒
恤金	卹金
续签	續簽
续弦	續絃
蓄发	蓄髮
蓄胡	蓄鬍
蓄须	蓄鬚
宣布	宣佈
宣传	宣傳
宣传周	宣傳週
喧哄	喧鬨
玄参	玄蔘
玄武	玄武
玄武岩	玄武岩
玄针	玄鍼
玄制	玄製
悬臂	懸臂
悬臂梁	懸臂樑
悬梁	懸樑
悬钟	懸鐘
悬胄	懸冑
旋干转坤	旋乾轉坤
旋回	旋迴
旋里	旋里
旋辟	旋辟
选择性换挡	選擇性換擋
削发	削髮
削面	削麪
薛松干	薛松乾
踅门了户	踅門瞭戶
雪窗萤几	雪窗螢几
雪梨兔肉羹	雪梨兔肉羹
雪松	雪松
血才干	血纔乾
血参	血蔘
血已干	血已乾
血症	血癥
勋业河山重	勳業河山重
熏草	燻草
熏风	薰風
熏风徐来	熏風徐來
熏腐	熏腐
熏赫	燻赫
熏黑	燻黑
熏鸡	燻雞
熏烤	燻烤
熏笼	熏籠
熏鑪	燻鑪
熏人	燻人
熏肉	燻肉
熏陶	薰陶
熏陶成性	熏陶成性
熏天	熏天
熏习	熏習
熏熏	熏熏
熏衣草	熏衣草
熏鱼	薰魚
熏鱼儿	燻魚兒
熏烝	熏烝
熏蒸	燻蒸
熏蒸剂	熏蒸劑
熏蒸室	熏蒸室
熏制	熏製
薰修	薰脩
巡回	巡迴
巡回检査	巡迴檢查
压杆	壓桿
压力	壓力
压力表	壓力錶
压面棍	壓麪棍
压胄子	壓冑子
崖广	崖广
哑子托梦	啞子托夢
雅游	雅游
雅致	雅緻
雅筑	雅筑
亚里	亞里
亚美尼亚	亞美尼亞
亚美尼亚历	亞美尼亞曆
亚青杯	亞青盃
亚松森	亞松森
亚洲	亞洲
亚洲杯	亞洲盃
咽不了	嚥不了
咽到	嚥到
咽干	咽乾
咽肌	嚥肌
咽进	嚥進
咽苦吞甘	嚥苦吞甘
咽了	嚥了
咽气	嚥氣
咽唾	嚥唾
咽下	嚥下
咽着	嚥着
咽住	嚥住
烟草	菸草
烟厂	菸廠
烟袋	菸袋
烟袋杆儿	菸袋桿兒
烟蒂	菸蒂
烟斗	菸斗
烟杆	煙桿
烟缸	菸缸
烟管	煙管
烟管面	煙管麪
烟害	菸害
烟灰	菸灰
烟碱	菸鹼
烟禁	菸禁
烟酒	菸酒
烟卷	菸捲
烟民	菸民
烟农	菸農
烟屁股	菸屁股
烟圈	菸圈
烟丝	菸絲
烟头	菸頭
烟霞肘后发	煙霞肘後發
烟熏	煙燻
烟熏火燎	煙熏火燎
烟蚜	菸蚜
烟叶	菸葉
烟纸店	菸紙店
烟嘴	菸嘴
腌里巴臜	腌裏巴臢
腌臜	腌臢
腌䐶	腌䐶
腌制	醃製
严云农	嚴云農
言辩而确	言辯而确
言大而夸	言大而夸
言事无不通	言事無不通
言云	言云
岩仓使节团	岩倉使節團
岩层	岩層
岩床	岩牀
岩村	巖村
岩村明宪	岩村明憲
岩基	岩基
岩浆	岩漿
岩浆岩	岩漿岩
岩礁	岩礁
岩濑	巖瀨
岩濑健	岩瀨健
岩脉	岩脈
岩棉	岩棉
岩圈	岩圈
岩溶	岩溶
岩石	岩石
岩土	岩土
岩隈驻朱轓	巖隈駐朱轓
岩屑	岩屑
岩心	岩心
岩盐	岩鹽
岩羊	岩羊
沿门托钵	沿門托鉢
研制	研製
筵几	筵几
眼干	眼乾
眼花	眼花
眼花了乱	眼花瞭亂
眼看庭树梅花发	眼看庭樹梅花發
眼前花发	眼前花發
眼酸	眼痠
偃仆	偃仆
偃松	偃松
艳后	豔后
唁吊	唁弔
验核	驗覈
餍于游乐	饜於游樂
燕几	燕几
扬谷	揚穀
扬舲望海岳	揚舲望海嶽
扬袂指辟支	揚袂指闢支
扬袂指松雪	揚袂指鬆雪
羊不食	羊不食
羊须	羊須
羊须疮	羊鬚瘡
羊质虎皮	羊質虎皮
阳春	陽春
阳春面	陽春麪
阳历	陽曆
杨采妮	楊采妮
杨穿三叶	楊穿三葉
杨凌	楊凌
杨凌示范区	楊淩示範區
杨日松	楊日松
杨士梁	楊士樑
杨松	楊松
杨苏棣	楊甦棣
杨文志	楊文誌
洋参	洋蔘
洋面	洋麪
洋烟	洋菸
养发	養髮
妖后	妖后
妖里妖气	妖里妖氣
腰杆	腰桿
腰间系	腰間繫
腰扣	腰釦
腰酸	腰痠
腰系	腰繫
腰一卷	腰一捲
侥天之幸	僥天之倖
侥幸	僥倖
姚采颖	姚采穎
姚升志	姚昇志
摇荡	搖盪
摇杆	搖桿
摇头公仔	搖頭公仔
遥辨雪山重	遙辨雪山重
遥怜驱匹马	遙憐驅匹馬
杳杳疏钟发	杳杳疏鍾發
咬姜呷醋	咬薑呷醋
药而愈	藥而癒
药面儿	藥麪兒
药物秘海岳	藥物祕海嶽
药皂	藥皂
要干了	要乾了
耶娘	耶孃
椰枣	椰棗
椰枣干	椰棗乾
噎饥	噎饑
爷饭娘羹	爺飯孃羹
爷羹娘饭	爺羹孃飯
爷娘	爺孃
也斗了胆	也斗了膽
野馆浓花发	野館濃花發
野姜	野薑
叶步梁	葉步樑
叶恭弘	叶恭弘
叶叶	葉葉
叶叶琹	葉叶琹
叶音	叶音
叶韵	叶韻
叶子	葉子
叶子杰	葉子杰
叶子烟	葉子菸
页岩	頁岩
夜光	夜光
夜光表	夜光錶
夜木似山中	夜木似山中
液晶	液晶
液晶表	液晶錶
液面	液麪
一别	一別
一别头	一彆頭
一并	一併
一冲性子	一沖性子
一出剧	一齣劇
一出子	一齣子
一斗	一斗
一斗斗	一斗斗
一发	一發
一发千钧	一髮千鈞
一发之差	一髮之差
一发之间	一髮之間
一分一毫	一分一毫
一杆	一杆
一杆进洞	一桿進洞
一干	一干
一干而尽	一乾而盡
一干二净	一乾二淨
一个	一箇
一锅面	一鍋麪
一毫一发	一毫一髮
一号木杆	一號木桿
一哄	一鬨
一见桃花发	一見桃花發
一块	一塊
一块面	一塊麪
一来当复去	一來當復去
一厘一毫	一釐一毫
一里	一里
一签	一簽
一窍不通	一竅不通
一日叫娘	一日叫孃
一日上树能千回	一日上樹能千回
一日之计在于晨	一日之計在於晨
一树百获	一樹百穫
一丝一毫	一絲一毫
一坛	一罈
一坛坛	一罈罈
一天	一天
一天钟	一天鐘
一托气	一托氣
一托头	一托頭
一物降一物	一物降一物
一物克一物	一物剋一物
一元大武	一元大武
一赞	一讚
一扎	一紮
一只	一隻
一枝繁果忆山中	一枝繁果憶山中
一周	一週
伊尔加拉	伊爾加拉
伊府面	伊府麪
伊里奇	伊里奇
伊洛曼希斯	伊洛曼希斯
伊面	伊麪
伊斯兰	伊斯蘭
伊斯兰历	伊斯蘭曆
伊于胡底	伊于胡底
伊于湖底	伊于湖底
衣摆	衣襬
衣不兼采	衣不兼采
衣不完采	衣不完采
衣不重采	衣不重采
衣斗木	衣斗木
衣锦夜游	衣錦夜游
衣锦昼游	衣錦晝游
衣扣	衣釦
衣衫	衣衫
衣衫已干	衣衫已乾
衣物	衣物
衣物渐干	衣物漸乾
衣物已干	衣物已乾
医托	醫托
依那普利	依那普利
依岩望松雪	依巖望鬆雪
噫吁戏	噫吁戲
怡普利	怡普利
宜云	宜云
胰脏	胰臟
移星换斗	移星換斗
遗传	遺傳
遗传钟	遺傳鐘
遗葑菲采	遺葑菲采
遗迹	遺蹟
疑系	疑係
乙丑	乙丑
已系	已係
已占	已佔
已占算	已占算
以功复过	以功覆過
蚁后	蟻后
倚托	倚托
倚闲	倚閑
倚岩望松雪	倚巖望鬆雪
蟻后	蟻后
亿只	億隻
义气	義氣
义气干霄	義氣干霄
仡栗	仡栗
亦舍下	亦捨下
亦云	亦云
异采	異采
异恶唑	異惡唑
异苔同岑	異薹同岑
异向流斜管	異向流斜管
抑扬	抑揚
抑扬升降性	抑揚昇降性
邑里	邑里
译制	譯製
译注	譯註
逸游自恣	逸游自恣
逸致	逸緻
意大利	意大利
意大利直面	意大利直麪
意面	意麪
因奸成孕	因姦成孕
阴干	陰乾
阴历	陰曆
阴占	陰占
茵借	茵藉
荫蔽	廕庇
荫监	廕監
荫生	廕生
荫袭	廕襲
荫子封妻	蔭子封妻
音声如钟	音聲如鐘
音信绝不通	音信絕不通
吟叹	吟歎
银杯	銀盃
银发	銀髮
银井桐花发	銀井桐花發
银丝	銀絲
银丝卷	銀絲捲
银须	銀鬚
银制	銀製
银朱	銀硃
淫欲	淫慾
嚚暗	嚚闇
隐几	隱几
飮胄	飮冑
印制	印製
英里	英里
英维普利	英維普利
樱花	櫻花
樱花杯	櫻花盃
鹰雕	鷹鵰
萦回	縈迴
萦系	縈繫
颍凤不来天地塞	潁鳳不來天地塞
影后	影后
影评	影評
影评人周	影評人週
影占	影占
影只形单	影隻形單
应见梅花发	應見梅花發
应有尽有	應有盡有
应占	應占
应钟	應鐘
硬面	硬麪
硬咽	硬嚥
佣钿	佣鈿
佣金	佣金
佣钱	佣錢
庸暗	庸闇
永历	永曆
永托于风	永託於風
永志	永志
永志不忘	永誌不忘
咏叹	詠歎
泳气钟	泳氣鐘
攸戚相关	攸慼相關
悠暗	悠闇
悠荡	悠盪
悠活丽致	悠活麗緻
悠悠	悠悠
悠悠荡荡	悠悠盪盪
悠悠驱匹马	悠悠驅匹馬
悠游	悠遊
悠游表	悠遊錶
尤里	尤里
由余	由余
犹恐失之	猶恐失之
犹如	猶如
犹如表	猶如錶
犹如钟	猶如鐘
犹使故林荣	猶使故林榮
犹太	猶太
犹太历	猶太曆
油面	油麪
油松	油松
莜面	莜麪
游尘	游塵
游出	游出
游到	游到
游芳来	游芳來
游过	遊過
游过来	游過來
游过去	游過去
游皓玮	游皓瑋
游鸿明	游鴻明
游鸿儒	游鴻儒
游回	游回
游击	遊擊
游击队	游擊隊
游击区	游擊區
游击手	游擊手
游击战	游擊戰
游进	遊進
游进来	游進來
游进去	游進去
游来	游來
游来游去	游來游去
游龙	游龍
游履	游履
游明金	游明金
游乃海	游乃海
游泮	游泮
游禽类	游禽類
游去	游去
游人曲岸看花发	遊人曲岸看花發
游僧攒住持	游僧攢住持
游山费虎皮	遊山費虎皮
游上	游上
游水	游水
游完	游完
游文宏	游文宏
游锡	遊錫
游锡坤	游錫坤
游锡昆	游錫昆
游锡堃	游錫堃
游戏	遊戲
游戏机	遊戲機
游戏机台	遊戲機檯
游下	游下
游盈隆	游盈隆
游泳	游泳
游囿伦	游囿倫
游鱼	游魚
游昭钦	游昭欽
游志宏	游志宏
友于	友于
有采	有采
有朝一日	有朝一日
有出好戏	有齣好戲
有发头陀寺	有髮頭陀寺
有够赞	有夠讚
有尽有让	有儘有讓
有进有出	有進有出
有云	有云
有征	有徵
有征无战	有征無戰
有只	有隻
羑里	羑里
牖里	牖里
又干	又幹
又干又硬	又乾又硬
又似呜咽流不通	又似嗚咽流不通
又云	又云
幼托	幼托
诱奸	誘姦
迂回	迂迴
纡回	紆迴
于贝尔	于貝爾
于斌	于斌
于波	于波
于晨楠	于晨楠
于成龙	于成龍
于成龍	于成龍
于从濂	于從濂
于從濂	于從濂
于大宝	于大寶
于丹	于丹
于道泉	于道泉
于德海	于德海
于尔岑	于爾岑
于尔根	于爾根
于尔里克	于爾里克
于爾里克	于爾里克
于飞	于飛
于风政	于風政
于凤桐	于鳳桐
于凤至	于鳳至
于格	于格
于根伟	于根偉
于光远	于光遠
于广洲	于廣洲
于归	于歸
于国	於國
于国桢	于國楨
于海洋	于海洋
于汉超	于漢超
于浩威	于浩威
于衡	于衡
于洪	於洪
于洪区	于洪區
于化虎	于化虎
于会泳	于會泳
于慧	于慧
于吉	于吉
于佳卉	于佳卉
于家	於家
于家堡	于家堡
于坚	于堅
于堅	于堅
于江震	于江震
于嗟	于嗟
于杰	于傑
于禁	于禁
于靖	于靖
于娟	于娟
于军	于軍
于軍	于軍
于康震	于康震
于克勒	于克勒
于孔兼	于孔兼
于勒	于勒
于里察	于里察
于凌奎	于凌奎
于冕	于冕
于敏	于敏
于明涛	于明濤
于默奥	于默奧
于娜	于娜
于品海	于品海
于奇库杜克	于奇庫杜克
于谦	于謙
于謙	于謙
于晴	于晴
于仁泰	于仁泰
于若木	于若木
于山	于山
于慎行	于慎行
于式枚	于式枚
于树洁	于樹潔
于帅	于帥
于帥	于帥
于双戈	于雙戈
于思	于思
于斯	於斯
于斯达尔	于斯達爾
于斯達爾	于斯達爾
于斯纳尔斯贝里	于斯納爾斯貝里
于斯納爾斯貝里	于斯納爾斯貝里
于斯塔德	于斯塔德
于素秋	于素秋
于台烟	于臺煙
于涛	于濤
于濤	于濤
于特森	于特森
于天仁	于天仁
于田	于田
于阗	于闐
于亭于里	於亭於裏
于韦斯屈莱	于韋斯屈萊
于韋斯屈萊	于韋斯屈萊
于伟国	于偉國
于西翰	于西翰
于湘兰	于湘蘭
于小	於小
于小彤	于小彤
于小伟	于小偉
于欣源	于欣源
于姓	于姓
于秀敏	于秀敏
于徐	于徐
于学忠	于學忠
于荫霖	于蔭霖
于永波	于永波
于右任	于右任
于幼军	于幼軍
于于	于于
于余曲折	于餘曲折
于馀曲折	于餘曲折
于玉立	于玉立
于远伟	于遠偉
于越	于越
于樂	于樂
于泽尔	于澤爾
于赠	于贈
于贈	于贈
于占元	于占元
于振	于振
于震环	于震環
于震寰	于震寰
于正昌	于正昌
于正升	于正昇
于志宁	于志寧
于寘	于寘
于子千	于子千
汙蔑	污衊
余碧芬	余碧芬
余秉谚	余秉諺
余炳贤	余炳賢
余灿荣	余燦榮
余车	余車
余发扬	余發揚
余干	餘干
余歌沧	余歌滄
余光	餘光
余光生	余光生
余光中	余光中
余兰香	余蘭香
余里	餘里
余男	余男
余珮琳	余珮琳
余三	餘三
余三胜	余三勝
余三勝	余三勝
余上沅	余上沅
余思	餘思
余思敏	余思敏
余天	余天
余威	餘威
余威德	余威德
余文	余文
余闻古夏后	餘聞古夏後
余吾镇	余吾鎮
余贤明	余賢明
余宪宗	余憲宗
余筱萍	余筱萍
余姓	余姓
余秀菁	余秀菁
余雪兰	余雪蘭
余雪明	余雪明
余亦浮于海	餘亦浮於海
余英时	余英時
余余	余余
余苑绮	余苑綺
余月	余月
余政宪	余政憲
余只	餘隻
余子	餘子
余子明	余子明
鱼干	魚乾
鱼鳞	魚鱗
鱼鳞松	魚鱗松
鱼游釜底	魚游釜底
鱼游釜中	魚游釜中
鱼胄	魚冑
馀力浮于海	餘力浮於海
逾闲荡检	逾閑蕩檢
愚暗	愚闇
舆尸	輿尸
与国同休	與國同休
宇宙	宇宙
宇宙志	宇宙誌
羽仪映松雪	羽儀映鬆雪
雨覆云翻	雨覆雲翻
语汇	語彙
语云	語云
玉斗	玉斗
玉里	玉里
玉历	玉曆
玉米	玉米
玉米须	玉米鬚
玉汝于成	玉汝於成
玉制	玉製
郁达夫	郁達夫
郁馥	郁馥
郁离子	郁離子
郁李	郁李
郁烈	郁烈
郁穆	郁穆
郁朴	郁樸
郁郁	鬱郁
郁郁菲菲	郁郁菲菲
郁郁青青	郁郁青青
郁哉	郁哉
预制	預製
欲海	慾海
欲壑难填	慾壑難填
欲火	慾火
欲加之罪	欲加之罪
欲加之罪何患无词	慾加之罪何患無詞
欲令智昏	慾令智昏
欲念	慾念
欲女	慾女
欲求	欲求
欲求不满	慾求不滿
欲善其事必先利其器	慾善其事必先利其器
欲望	慾望
欲障	慾障
喻德高	喻德高
御敌	禦敵
御寒	禦寒
御寇	禦寇
御侮	禦侮
御制	御製
寓禁于征	寓禁於征
愈合	癒合
元后	元后
袁友范	袁友范
袁于令	袁于令
原钟	原鐘
原子	原子
原子钟	原子鐘
缘涧还复去	緣澗還復去
缘源杂花发	緣源雜花發
猿声寒过水	猿聲寒過水
远县才至	遠縣纔至
远征	遠征
愿而恭	愿而恭
愿君采葑菲	願君採葑菲
愿朴	愿樸
曰云	曰云
约翰	約翰
约翰松	約翰松
月迥藏珠斗	月迥藏珠鬥
月历	月曆
月相	月相
月相表	月相錶
月岩	月岩
岳飞	岳飛
岳坟	岳墳
岳父	岳父
岳家	岳家
岳珂	岳珂
岳庙	岳廟
岳母	岳母
岳氏	岳氏
岳阳	岳陽
岳云	岳雲
岳丈	岳丈
煴斗	熅斗
云城	雲城
云城区	云城區
云尔	云爾
云翻雨复	雲翻雨覆
云寒水清荻花发	雲寒水清荻花發
云何	云何
云乎	云乎
云然	云然
云山且喜重重见	雲山且喜重重見
云吞	雲吞
云吞面	雲吞麪
云为	云爲
云爲	云爲
云溪	云溪
云须	雲鬚
云云	云云
芸辉	蕓輝
芸苔	蕓薹
芸薹	蕓薹
耘荡	耘盪
允准	允准
陨获	隕穫
酝借	醞藉
蕴借	蘊藉
熨斗	熨斗
杂合面儿	雜合麪兒
杂酱面	雜醬麪
杂面	雜麪
杂志	雜誌
再制	再製
在核	在覈
赞呗	讚唄
赞不绝口	讚不絕口
赞词	讚詞
赞辞	讚辭
赞道	讚道
赞的	讚的
赞歌	讚歌
赞个不	讚個不
赞口不	讚口不
赞乐	讚樂
赞了	讚了
赞两句	讚兩句
赞美	讚美
赞佩	讚佩
赞赏	讚賞
赞颂	讚頌
赞叹	讚歎
赞歎	讚歎
赞我	讚我
赞羡	讚羨
赞许	讚許
赞扬	讚揚
赞一句	讚一句
赞一声	讚一聲
赞一赞	讚一讚
赞语	讚語
赞誉	讚譽
赞自己	讚自己
脏发	髒髮
脏腑	臟腑
脏器	臟器
臧谷亡羊	臧穀亡羊
凿岩	鑿巖
凿岩机	鑿岩機
早起	早起
早起的鸟儿有虫吃	早起的鳥兒有蟲吃
早占勿药	早占勿藥
皂化	皂化
皂荚	皂莢
灶下烹只鸡	竈下烹只雞
造曲	造麴
造岩矿物	造岩礦物
造钟	造鐘
噪动	譟動
噪诈	譟詐
泽里可	澤里可
泽卤	澤鹵
泽渗漓而下降	澤滲灕而下降
扎成	紮成
扎带	紮帶
扎囮	紮囮
扎尔达里	扎爾達里
扎根	紮根
扎裹	紮裹
扎好	紮好
扎脚	紮腳
扎结	紮結
扎紧	紮緊
扎了	紮了
扎马剌丁	紮馬剌丁
扎马鲁丁	紮馬魯丁
扎欧扎翁	紮歐紮翁
扎起	紮起
扎上	紮上
扎实	紮實
扎铁	紮鐵
扎下	紮下
扎线带	紮線帶
扎营	紮營
扎在	紮在
扎扎	扎扎
扎扎实实	紮紮實實
扎诈	紮詐
扎寨	紮寨
札夸威	札夸威
轧制	軋製
炸毁	炸燬
炸酱面	炸醬麪
榨干	榨乾
詹志维	詹誌維
薝卜	薝蔔
展采	展采
占拜	占拜
占卜	占卜
占城	占城
占断	占斷
占房	占房
占风使帆	占風使帆
占凤	占鳳
占卦	占卦
占候	占候
占课	占課
占了	佔了
占了卜	占了卜
占梦	占夢
占强	占強
占亲	占親
占人	占人
占上	占上
占射	占射
占身	占身
占筮	占筮
占万	佔万
占星	占星
占验	占驗
占有	佔有
占有五不验	占有五不驗
占有欲	佔有慾
占主	佔主
占主导地位	占主導地位
战略	戰略
战略伙伴	戰略伙伴
站干岸儿	站乾岸兒
张斗辉	張斗輝
张基郁	張基郁
张木松	張木松
张琴	張琴
张琴松	張琴松
张三	張三
张三丰	張三丰
张文松	張文松
张志	張志
张志家	張誌家
长发	長髮
长干曲	長干曲
长干巷	長干巷
长胡	長鬍
长几	長几
长历	長曆
长绳系景	長繩繫景
长绳系日	長繩繫日
长寿	長壽
长寿烟	長壽菸
长吁	長吁
长须	長鬚
长征	長征
丈母	丈母
丈母娘	丈母孃
丈人嗣三叶	丈人嗣三葉
仗托	仗托
招远县	招遠縣
昭假于天	昭假於天
赵坤郁	趙坤郁
照签	照簽
遮复	遮覆
折尺	摺尺
折叠	摺疊
折好	摺好
折合	摺合
折痕	摺痕
折进	折進
折进来	摺進來
折进去	摺進去
折篷	摺篷
折裙	摺裙
折扇	摺扇
折台	折檯
折梯	摺梯
折页	摺頁
折椅	摺椅
折纸	摺紙
折子	摺子
折奏	摺奏
这出电影	這齣電影
这出好戏	這齣好戲
这出剧	這齣劇
这只	這隻
这钟	這鐘
针砭	鍼砭
针关	鍼關
针芥相投	鍼芥相投
针灸	鍼灸
针口	鍼口
针扣	針釦
针芒	鍼芒
珍珠	珍珠
珍珠岩	珍珠岩
甄后	甄后
枕借	枕藉
枕席	枕蓆
缜致	縝緻
鬒发	鬒髮
振荡	振盪
振杰	振杰
赈饥	賑饑
震荡	震盪
镇荣里	鎮榮里
镇吴称奥里	鎮吳稱奧裏
镇远县	鎮遠縣
黮暗	黮闇
征尘	征塵
征程	征程
征伐	征伐
征帆	征帆
征夫	征夫
征服	征服
征驾	征駕
征剿	征剿
征敛	征斂
征马	征馬
征旆	征旆
征辟	徵辟
征衫	征衫
征戍	征戍
征讨	征討
征途	征途
征衣	征衣
征战	征戰
征彸	征彸
蒸干	蒸乾
蒸面	蒸麪
整出剧	整齣劇
整发	整發
整发用品	整髮用品
整只	整隻
整周	整週
正梁	正樑
正凶	正凶
郑福生	鄭福生
郑家	鄭家
郑家钟	鄭家鐘
郑凯云	鄭凱云
郑荣松	鄭榮松
郑易里	鄭易里
郑余豪	鄭余豪
症结	癥結
鄭凱云	鄭凱云
之欲	之慾
之钟	之鐘
支杆	支桿
支努干	支努干
支烟	支菸
只査	只查
只吃	只吃
只道梅花发	只道梅花發
只鸡絮酒	隻雞絮酒
只立	隻立
只轮不反	隻輪不反
只轮不返	隻輪不返
只日	隻日
只如鸡卵一物	只如雞卵一物
只身	隻身
只声不出	隻聲不出
只手	隻手
只言片语	隻言片語
只言片字	隻言片字
只眼	隻眼
只影	隻影
只占	只佔
只占吉	只占吉
只占神问卜	只占神問卜
只占算	只占算
只准	只准
只字	隻字
枝不得大于干	枝不得大於榦
知在雪山中	知在雪山中
织席	織蓆
直摆	直襬
直道济时宪	直道濟時憲
直发	直髮
直系	直系
直系军阀	直係軍閥
直置保松筠	直置保鬆筠
植发	植髮
植物	植物
植物志	植物誌
殖谷	殖穀
止谤莫如自修	止謗莫如自脩
纸烟	紙菸
纸扎	紙紮
纸制	紙製
指挥	指揮
指挥台	指揮台
指亲托故	指親托故
指水盟松	指水盟松
趾高气扬	趾高氣揚
志哀	誌哀
志冲斗牛	志沖斗牛
志悼	誌悼
志高气扬	志高氣揚
志庆	誌慶
志喜	誌喜
志异	誌異
志之不忘	誌之不忘
制版	製版
制备	製備
制表	製表
制冰	製冰
制播	製播
制材	製材
制茶	製茶
制成	製成
制程	製程
制出	製出
制得	製得
制毒	製毒
制法	製法
制革	製革
制剂	製劑
制假	製假
制件	製件
制浆	製漿
制冷	製冷
制面	制面
制面具	製面具
制坯	製坯
制片	製片
制品	製品
制取	製取
制售	製售
制酸	制酸
制酸性	製酸性
制糖	製糖
制陶	製陶
制图	製圖
制为	製爲
制爲	製爲
制鞋	製鞋
制盐	製鹽
制氧	製氧
制药	製藥
制衣	製衣
制造	製造
制纸	製紙
制钟	制鐘
制作	製作
制做	製做
治愈	治癒
栉发工	櫛髮工
致密	緻密
窒欲	窒慾
智小言大	智小言大
踬仆	躓仆
薙发	薙髮
中保一号	中保一號
中国	中國
中国制	中國製
中环杯	中環盃
中仑	中崙
中型	中型
中型钟	中型鐘
中游	中游
忠人之托	忠人之托
终端	終端
终端台	終端檯
终南卧松雪	終南臥鬆雪
终身	終身
终身有托	終身有托
终岁竟不食	終歲竟不食
钟摆	鐘擺
钟被	鐘被
钟壁	鐘壁
钟表	鐘錶
钟表盘	鐘表盤
钟不	鐘不
钟差	鐘差
钟楚红	鐘楚紅
钟的	鐘的
钟点	鐘點
钟顶	鐘頂
钟鼎	鐘鼎
钟发音	鐘發音
钟福松	鐘福松
钟鼓	鐘鼓
钟关	鐘關
钟行	鐘行
钟好	鐘好
钟匠	鐘匠
钟口	鐘口
钟快	鐘快
钟乐	鐘樂
钟楼	鐘樓
钟漏	鐘漏
钟螺	鐘螺
钟律	鐘律
钟慢	鐘慢
钟没	鐘沒
钟面	鐘面
钟鸣	鐘鳴
钟模	鐘模
钟纽	鐘紐
钟盘	鐘盤
钟珮瑄	鐘珮瑄
钟敲	鐘敲
钟琴	鐘琴
钟磬	鐘磬
钟乳洞	鐘乳洞
钟乳石	鐘乳石
钟山	鐘山
钟上	鐘上
钟身	鐘身
钟声	鐘聲
钟速	鐘速
钟塔	鐘塔
钟太	鐘太
钟体	鐘體
钟调	鐘調
钟停	鐘停
钟头	鐘頭
钟王	鐘王
钟下	鐘下
钟相	鐘相
钟响	鐘響
钟形	鐘形
钟腰	鐘腰
钟意	鐘意
钟有	鐘有
钟在寺里	鐘在寺裏
钟罩	鐘罩
钟左右	鐘左右
钟座	鐘座
种放	种放
种谷	種穀
种师道	种師道
种师中	种師中
重复	重複
重见复出	重見複出
重罗面	重羅麪
重折	重摺
重制	重製
州里	州里
周报	週報
周而复始	週而復始
周二	週二
周回	週迴
周会	週會
周记	週記
周济	賙濟
周杰	周杰
周刊	週刊
周考	週考
周历	周曆
周六	週六
周末	週末
周年	週年
周期	週期
周人	周人
周人之急	賙人之急
周日	週日
周三	週三
周上	週上
周数	週數
周四	週四
周岁	週歲
周五	週五
周薪	週薪
周休	週休
周一	週一
周中	週中
周周	週週
周转	週轉
周走秀	週走秀
洲际	洲際
洲际杯	洲際盃
咒愿	咒愿
胄甲	冑甲
胄科	冑科
昼伏夜游	晝伏夜游
皱别	皺彆
皱折	皺摺
朱笔	硃筆
朱布瓦尔	朱布瓦爾
朱唇	朱脣
朱唇皓齿	硃脣皓齒
朱轓皂盖	朱轓皂蓋
朱干玉戚	朱干玉鏚
朱红	硃紅
朱卷	硃卷
朱俊	朱儁
朱理安历	朱理安曆
朱仑街	朱崙街
朱批	硃批
朱色	硃色
朱砂	硃砂
朱郁信	朱郁信
朱谕	硃諭
珠斗烂班	珠斗爛班
诸岭一何小	諸嶺一何小
猪八戒	豬八戒
猪八戒吃人参果	豬八戒吃人參果
猪肝	豬肝
猪肝面	豬肝麪
猪脚面	豬腳麪
猪舌	豬舌
猪舌面	豬舌麪
猪只	豬隻
竹苞松茂	竹苞松茂
竹几	竹几
竹席	竹蓆
竹制	竹製
主梁	主樑
主钟曲线	主鐘曲線
煮面	煮麪
煮粥焚须	煮粥焚鬚
伫因舂斗粟	佇因舂鬥粟
芧栗	芧栗
住扎	住紮
注标	註標
注冊	註冊
注册	註冊
注定	註定
注记	註記
注脚	註腳
注解	註解
注名	註名
注明	註明
注批	註批
注入	注入
注入式敎学法	注入式教學法
注上	註上
注生娘娘	註生娘娘
注失	註失
注释	註釋
注疏	註疏
注文	註文
注销	註銷
注译	註譯
注云	注云
驻扎	駐紮
柱梁	柱樑
祝发	祝髮
祝赞	祝讚
铸型涂浆	鑄型塗漿
铸钟	鑄鐘
筑邦	筑邦
筑北	筑北
筑波	筑波
筑肥	筑肥
筑后	筑後
筑後	筑後
筑前	筑前
筑西	筑西
筑阳	筑陽
筑陽	筑陽
筑州	筑州
筑紫	筑紫
抓奸	抓姦
专鉴	專鑒
专征	專征
转经唯有一窗明	轉經唯有一窗明
转速	轉速
转速表	轉速錶
转台	轉檯
转游	轉游
转注	轉註
装岩机	裝岩機
装折	裝摺
壮面	壯麪
壮气吞牛	壯氣吞牛
撞府冲州	撞府沖州
撞球杆	撞球桿
撞钟	撞鐘
准保	準保
准保护	准保護
准保释	准保釋
准不准你	准不准你
准不准谁	准不准誰
准不准他	准不准他
准不准它	准不准它
准不准她	准不准她
准不准我	准不准我
准不准许	准不准許
准此	准此
准伏	准伏
准假	准假
准将	准將
准决斗	准決鬥
准考证	准考證
准普尔	准普爾
准入	准入
准三后	准三后
准算	准算
准尉	准尉
准许	准許
准以	准以
准予	准予
准折	准折
准奏	准奏
捉发	捉髮
捉风捕影	捉風捕影
捉奸	捉姦
捉影捕风	捉影捕風
桌几	桌几
桌历	桌曆
浊积岩	濁積岩
擢发	擢髮
姿采	姿采
兹言庶不负	茲言庶不負
资本利得	資本利得
髭胡	髭鬍
髭须	髭鬚
子宫套扎线	子宮套扎線
子姜	子姜
子姜炒鸡	子薑炒雞
子游	子游
子云	子云
子之丰兮	子之丰兮
梓里	梓里
紫姜	紫薑
紫云	紫雲
紫云苗族布依族自治县	紫云苗族布依族自治縣
自从得向蓬莱里	自從得向蓬萊裏
自动	自動
自动表	自動錶
自怜驱匹马	自憐驅匹馬
自然	自然
自然卷	自然捲
自然生态环境	自然生態環境
自制	自制
自制炸弹	自製炸彈
字汇	字彙
渍已干	漬已乾
宗周	宗周
宗周钟	宗周鐘
综核	綜覈
总发	總髮
总杆赛	總桿賽
总杆数	總桿數
总汇	總彙
总台	總檯
总统	總統
总统杯	總統盃
纵横	縱橫
纵横交布	縱橫交佈
纵欲	縱慾
粽粑叶	粽粑葉
奏折	奏摺
足高气扬	足高氣揚
足协	足協
足协杯	足協盃
足总杯	足總盃
祖冲之	祖沖之
钻杆	鑽桿
醉骑白花马	醉騎白花馬
左光斗	左光斗
左里克	左里克
左邻右里	左鄰右里
左手	左手
左手不托右手	左手不托右手
左右	左右
左右采之	左右采之
佐芬普利	佐芬普利
作幸	作倖
坐标	座標
坐如钟	坐如鐘
坐台	坐檯
坐钟	坐鐘
座钟	座鐘
做出	做出
做出好戏	做齣好戲