僞	偽
兇	凶
啓	啟
喫	吃
嫺	嫻
嬀	媯
峯	峰
幺	么
擡	抬
曬	晒
棱	稜
檐	簷
污	汙
泄	洩
涌	湧
潙	溈
潨	潀
爲	為
牀	床
痹	痺
癡	痴
着	著
睾	睪
竈	灶
糉	粽
繮	韁
纔	才
羣	群
蔿	蒍
衆	眾
裏	裡
覈	核
踊	踴
鉢	缽
鮎	鯰
麪	麵
齶	顎
砹	砈
硅	矽
酰	醯
鈁	鍅
鈈	鈽
錇	鉳
鍀	鎝
鎄	鑀
鎇	鋂
鎿	錼
鐦	鉲
鑥	鎦
PN結	PN接面
SQL注入	SQL隱碼攻擊
SQL注入攻擊	SQL隱碼攻擊
阿拉伯聯合酋長國	阿拉伯聯合大公國
阿塞拜疆	亞塞拜然
埃塞俄比亞	衣索比亞
安提瓜和巴布達	安地卡及巴布達
巴巴多斯	巴貝多
巴布亞新幾內亞	巴布亞紐幾內亞
半角	半形
綁定	繫結
保存	儲存
貝寧	貝南
奔馳	賓士
本地代碼	原生代碼
蹦極	高空彈跳
比特	位元
筆記本電腦	膝上型電腦
壁紙	桌布
編程	程式設計
編程語言	程式語言
便攜式	行動式
變量	變數
標識符	識別符號
表達式	表示式
並行計算	平行計算
波分複用	波長分波多工
波斯尼亞黑塞哥維那	波士尼亞赫塞哥維納
伯利茲	貝里斯
博茨瓦納	波札那
博客	部落格
布爾	布林
布基納法索	布吉納法索
布隆迪	蒲隆地
採樣	取樣
菜單	選單
參數	引數
參數表	參數列
操作數	運算元
操作系統	作業系統
插件	外掛
查看	檢視
查找	查詢
場效應管	場效電晶體
城域網	都會網路
程序	程式
程序員	程式設計師
持久性	永續性
出租車	計程車
觸摸	觸控
觸摸屏	觸控式螢幕
傳感	感測
串行	序列
串行端口	串列埠
串口	串列埠
窗口	視窗
創建	建立
詞組	片語
磁道	磁軌
磁盤	磁碟
存儲	儲存
存盤	存檔
打開	開啟
打印	列印
打印機	印表機
代碼	程式碼
代碼頁	內碼表
帶寬	頻寬
單片機	微控制器
刀片服務器	刀鋒伺服器
導出	匯出
導入	匯入
登錄	登入
低級	低階
地址	地址
地址欄	位址列
遞歸	遞迴
點擊	點選
調度	排程
調色板	調色盤
調試	除錯
調試器	偵錯程式
調用	呼叫
調制	調變
調製解調器	數據機
端口	埠
短信	簡訊
堆棧	堆疊
隊列	佇列
對話框	對話方塊
對象	物件
多米尼加	多明尼加
多任務	多工
多態	多型
厄瓜多爾	厄瓜多
厄立特里亞	厄利垂亞
二極管	二極體
發佈	釋出
發送	傳送
範式	正規化
方便麪	泡麵
仿真	模擬
飛行模式	飛航模式
分辨率	解析度
分佈式	分散式
分區	分割槽
佛得角	維德角
服務器	伺服器
輔音	子音
傅里葉	傅立葉
複選按鈕	覈取按鈕
複選框	覈取方塊
複印	影印
岡比亞	甘比亞
高端	高階
高級	高階
高速緩存	快取記憶體
高性能計算	高效能運算
哥斯達黎加	哥斯大黎加
格林納達	格瑞那達
格魯吉亞	喬治亞
構造函數	建構函式
固件	韌體
掛斷	結束通話
關係數據庫	關聯式資料庫
光標	游標
光盤	光碟
光驅	光碟機
圭亞那	蓋亞那
過程式編程	程序式程式設計
哈薩克斯坦	哈薩克
哈希	雜湊
函數	函式
函數式編程	函數語言程式設計
航天飛機	太空梭
宏內核	單核心
洪都拉斯	宏都拉斯
紅心大戰	傷心小棧
後綴	字尾
呼出	撥出
呼叫轉移	來電轉駁
互聯網	網際網路
緩存	快取
回調	回撥
彙編	彙編
彙編語言	組合語言
基里巴斯	吉里巴斯
激光	鐳射
激活	啟用
吉布堤	吉布地
集成	整合
集成電路	積體電路
集羣	叢集
幾內亞比紹	幾內亞比索
計算機安全	電腦保安
計算機科學	電腦科學
寄存器	暫存器
加納	迦納
加蓬	加彭
加載	載入
兼容	相容
剪切	剪下
剪貼板	剪貼簿
交互	互動
腳本	指令碼
接口	介面
截屏	截圖
截取	擷取
解釋器	直譯器
界面	介面
金屬氧化物半導體	金氧半導體
津巴布韋	辛巴威
進程	程序
進制	進位制
晶體管	電晶體
晶閘管	閘流體
鏡像	映象
局部	區域性
局域網	區域網
句柄	控制代碼
捲積	摺積
咖喱	咖哩
卡塔爾	卡達
科摩羅	葛摩
科特迪瓦	象牙海岸
可視化	視覺化
克羅地亞	克羅埃西亞
刻錄	燒錄
肯尼亞	肯亞
空分多址	分空間多重進接
空分複用	空間多工
控件	控制元件
寬帶	寬頻
擴展	擴充套件
擴展名	副檔名
萊索托	賴索托
藍牙	藍芽
老撾	寮國
類模板	類别範本
類型	型別
利比里亞	賴比瑞亞
連接	連線
連接器	聯結器
聯繫	聯絡
聯繫歷史	通話記錄
鏈表	連結串列
鏈接	連結
涼菜	冷盤
列支敦士登	列支敦斯登
盧旺達	盧安達
錄像	錄影
邏輯門	邏輯閘
馬爾代夫	馬爾地夫
馬里共和國	馬利共和國
碼分多址	分碼多重進接
碼率	位元速率
毛里求斯	模里西斯
毛里塔尼亞	茅利塔尼亞
冒泡排序	氣泡排序
枚舉	列舉
門電路	閘電路
門戶網站	入口網站
密鑰	金鑰
免提	擴音
面向對象	物件導向
面向過程	程序導向
命令行	命令列
命令式編程	指令式程式設計
命名空間	名稱空間
模塊	模組
模擬	模擬
模擬電路	類比電路
模擬電子	類比電子
莫桑比克	莫三比克
默認	預設
目標代碼	目的碼
納米	奈米
奶酪	乳酪
瑙魯	諾魯
內存	記憶體
內核	核心
內聯函數	行內函數
內置	內建
尼日爾	尼日
尼日利亞	奈及利亞
歐拉	尤拉
帕勞	帛琉
盤符	碟符
盤片	碟片
拋出	丟擲
皮膚	面板
頻分多址	分頻多重進接
頻分複用	分頻多工
屏蔽	遮蔽
屏幕	螢幕
前綴	字首
嵌套	巢狀
全角	全形
全局	全域性
權限	許可權
缺省	預設
任務管理器	工作管理員
任務欄	工作列
軟件	軟體
軟驅	軟碟機
塞拉利昂	獅子山
塞浦路斯	塞普勒斯
塞舌爾	塞席爾
三極管	三極體
散列	雜湊
掃描儀	掃描器
沙特阿拉伯	沙烏地阿拉伯
殺毒	防毒
閃存	快閃記憶體
社區	社羣
設備	裝置
設置	設定
審覈	稽覈
聲卡	音效卡
聲明	宣告
聖基茨和尼維斯	聖克里斯多福及尼維斯
聖盧西亞	聖露西亞
聖馬力諾	聖馬利諾
聖文森特和格林納丁斯	聖文森及格瑞那丁
時分多址	分時多重進接
時分複用	分時多工
時鐘頻率	時脈頻率
實例	例項
實模式	真實模式
矢量	向量
視頻	視訊
視圖	檢視
適配器	介面卡
首席技術官	技術長
首席信息官	資訊長
首席運營官	營運長
首席執行官	執行長
鼠標	滑鼠
數據	資料
數據報	資料包
數據倉庫	資料倉儲
數據挖掘	資料探勘
數據源	資料來源
數字	數字
數字電路	數位電路
數字電子	數位電子
數字印刷	數位印刷
數組	陣列
刷新	重新整理
斯洛文尼亞	斯洛維尼亞
斯威士蘭	史瓦濟蘭
死機	宕機
搜索	搜尋
蘇里南	蘇利南
算法	演算法
算子	運算元
縮進	縮排
縮略圖	縮圖
所羅門羣島	索羅門羣島
索馬里	索馬利亞
塔吉克斯坦	塔吉克
臺式機	桌上型電腦
坦桑尼亞	坦尚尼亞
特立尼達和多巴哥	千里達及托巴哥
添加	新增
通配符	萬用字元
通信	通訊
通訊卡	通話卡
頭文件	標頭檔案
突尼斯	突尼西亞
圖標	圖示
圖庫	相簿
圖瓦盧	吐瓦魯
圖像	影象
土庫曼斯坦	土庫曼
脫機	離線
瓦努阿圖	萬那杜
外鍵	外來鍵
外置	外接
萬維網	全球資訊網
萬象	永珍
網吧	網咖
網關	閘道器
網卡	網絡卡
網絡	網路
網上鄰居	網路上的芳鄰
危地馬拉	瓜地馬拉
僞代碼	虛擬碼
位圖	點陣圖
溫納圖萬	那杜
文本	文字
文檔	文件
文件	檔案
文件夾	資料夾
文件擴展名	副檔名
文件名	檔名
文萊	汶萊
文字處理	文書處理
烏茲別克斯坦	烏茲別克
無損壓縮	無失真壓縮
物理地址	實體地址
物理內存	實體記憶體
析構函數	解構函式
下拉列表	下拉選單
仙童半導體	快捷半導體
顯存	視訊記憶體
顯卡	顯示卡
顯像管	映象管
線程	執行緒
相冊	相簿
香農	夏農
項目	專案
像素	畫素
消息	訊息
寫保護	防寫
卸載	解除安裝
芯片	晶片
新西蘭	紐西蘭
信道	通道
信號	訊號
信息	資訊
信息安全	資訊保安
信息技術	資訊科技
信息論	資訊理論
信噪比	訊雜比
性價比	價效比
性能	效能
虛函數	虛擬函式
虛擬機	虛擬機器
循環	迴圈
尋址	定址
演示文稿	簡報
也門	葉門
頁腳	頁尾
頁眉	頁首
移動電話	行動電話
移動通信	行動通訊
移動網絡	行動網路
移動硬盤	行動硬碟
移動資料	行動資料
以太網	乙太網
異步	非同步
意大利	義大利
溢出	溢位
音頻	音訊
引導程序	載入程式
映射	對映
硬件	硬體
硬盤	硬碟
用戶	使用者
用戶名	使用者名稱
優先級	優先順序
有損壓縮	有失真壓縮
預處理器	前處理器
元編程	超程式設計
元數據	後設資料
元音	母音
原代碼	原始碼
源代碼	原始碼
源碼	原始碼
源文件	原始檔
遠程	遠端
雲存儲	雲端儲存
雲計算	雲端計算
運行	執行
運算符	運算子
在線	線上
贊比亞	尚比亞
乍得	查德
粘貼	貼上
正則表達式	正規表示式
支持	支援
知識產權	智慧財產權
指針	指標
智能	智慧
中間件	中介軟體
重命名	重新命名
重載	過載
重裝	重灌
主板	主機板
主引導記錄	主開機記錄
註冊表	登錄檔
註冊機	序號產生器
註銷	登出
狀態欄	狀態列
桌面型	桌上型
自動轉屏	自動旋轉螢幕
自行車	腳踏車
字段	欄位
字符	字元
字符串	字串
字節	位元組
字庫	字型檔
字體	字型
總線	匯流排
組件	元件
最終用戶	終端使用者